title: So sánh điện thoại Samsung Galaxy A53 và A73, máy nào tốt hơn?	title : So sánh điện thoại Samsung Galaxy A53 và A73 , máy nào tốt hơn ?

Samsung  là một trong những thương hiệu  điện thoại thông minh  được ưa chuộng tại Việt Nam bởi mẫu mã đa dạng và nhiều tiện ích.	Samsung là một trong những thương hiệu điện thoại thông minh được ưa chuộng tại Việt Nam bởi mẫu mã đa dạng và nhiều tiện ích .

Cùng  Thế Giới Di Động  so sánh  Samsung Galaxy A53  với  Samsung Galaxy A73  ngay trong bài viết sau đây nhé!	Cùng Thế Giới Di Động so sánh Samsung Galaxy A53 với Samsung Galaxy A73 ngay trong bài viết sau đây nhé !

1.	1 .

Tổng quan điện thoại Samsung Galaxy A53	Tổng quan điện thoại Samsung Galaxy A53

Samsung Galaxy A53 ra mắt vào năm 2022 là một chiếc điện thoại tầm trung được giới công nghệ không tiếc lời khen bởi sở hữu nhiều tính năng vượt trội hơn Galaxy A52 nhưng giá lại rẻ hơn so với phiên bản Galaxy A73 5G cao cấp.	Samsung Galaxy A53 ra mắt vào năm 2022 là một chiếc điện thoại tầm trung được giới công nghệ không tiếc lời khen bởi sở hữu nhiều tính năng vượt trội hơn Galaxy A52 nhưng giá lại rẻ hơn so với phiên bản Galaxy A73 5G cao cấp .
{"subject": ["1&&Samsung", "2&&Galaxy", "3&&A53"], "object": ["33&&Galaxy", "34&&A52"], "aspect": ["28&&tính", "29&&năng"], "predicate": ["27&&nhiều", "28&&tính", "29&&năng", "30&&vượt", "31&&trội", "32&&hơn"], "label": "COM+"}
{"subject": ["1&&Samsung", "2&&Galaxy", "3&&A53"], "object": ["44&&Galaxy", "45&&A73", "46&&5G"], "aspect": ["36&&giá"], "predicate": ["38&&rẻ", "39&&hơn"], "label": "COM+"}

Chiếc Galaxy A3 được xem là át chủ bài khi được trang bị nhiều công nghệ ấn tượng như camera sắc nét giúp bắt trọn khoảnh khắc, hiệu năng Exynox 1280 tha hồ chiến game, hay thời gian sạc pin nhanh hơn đem lại trải nghiệm tuyệt vời cho người dùng.	Chiếc Galaxy A3 được xem là át chủ bài khi được trang bị nhiều công nghệ ấn tượng như camera sắc nét giúp bắt trọn khoảnh khắc , hiệu năng Exynox 1280 tha hồ chiến game , hay thời gian sạc pin nhanh hơn đem lại trải nghiệm tuyệt vời cho người dùng .

alt: Samsung Galaxy A53 là một chiếc điện thoại tầm trung được giới công nghệ không tiếc lời khen	alt : Samsung Galaxy A53 là một chiếc điện thoại tầm trung được giới công nghệ không tiếc lời khen

des: Samsung Galaxy A53 là một chiếc điện thoại tầm trung được giới công nghệ không tiếc lời khen	des : Samsung Galaxy A53 là một chiếc điện thoại tầm trung được giới công nghệ không tiếc lời khen

Samsung Galaxy A53 là một chiếc điện thoại tầm trung được giới công nghệ không tiếc lời khen.	Samsung Galaxy A53 là một chiếc điện thoại tầm trung được giới công nghệ không tiếc lời khen .

2.	2 .

Tổng quan về điện thoại Samsung Galaxy A73	Tổng quan về điện thoại Samsung Galaxy A73

Samsung Galaxy A73 được ra mắt vào  năm 2022  và là sản phẩm nổi bật nhất trong dòng Galaxy A và là sản phẩm tầm trung đáng mua.	Samsung Galaxy A73 được ra mắt vào năm 2022 và là sản phẩm nổi bật nhất trong dòng Galaxy A và là sản phẩm tầm trung đáng mua .
{"subject": ["1&&Samsung", "2&&Galaxy", "3&&A73"], "object": [], "aspect": [], "predicate": ["14&&nổi", "15&&bật", "16&&nhất", "17&&trong", "18&&dòng", "19&&Galaxy", "20&&A"], "label": "SUP+"}

Chiếc điện thoại này được trang bị nhiều thông số kỹ thuật ấn tượng đem đến trải nghiệm thú vị.	Chiếc điện thoại này được trang bị nhiều thông số kỹ thuật ấn tượng đem đến trải nghiệm thú vị .

Với chất lượng màn hình và camera có độ phân giải lên đến 108 MP cho bạn tha hồ thỏa sức nhiếp ảnh.	Với chất lượng màn hình và camera có độ phân giải lên đến 108 MP cho bạn tha hồ thỏa sức nhiếp ảnh .

Nhờ được trang bị chipset mạnh mẽ đến từ nhà sản xuất Qualcomm mà Galaxy A73 vận hành khá ổn định.	Nhờ được trang bị chipset mạnh mẽ đến từ nhà sản xuất Qualcomm mà Galaxy A73 vận hành khá ổn định .

alt: Samsung Galaxy A73 là sản phẩm nổi bật nhất trong dòng Galaxy A	alt : Samsung Galaxy A73 là sản phẩm nổi bật nhất trong dòng Galaxy A

des: Samsung Galaxy A73 là sản phẩm nổi bật nhất trong dòng Galaxy A	des : Samsung Galaxy A73 là sản phẩm nổi bật nhất trong dòng Galaxy A

Samsung Galaxy A73 là sản phẩm nổi bật nhất trong dòng Galaxy A.	Samsung Galaxy A73 là sản phẩm nổi bật nhất trong dòng Galaxy A .

3.	3 .

So sánh điện thoại Samsung Galaxy A53 với Samsung Galaxy A73	So sánh điện thoại Samsung Galaxy A53 với Samsung Galaxy A73

Thiết kế và màu sắc	Thiết kế và màu sắc

Nhìn chung cả 2 chiếc điện thoại này không có sự khác biệt lớn về thiết kế và màu sắc.	Nhìn chung cả 2 chiếc điện thoại này không có sự khác biệt lớn về thiết kế và màu sắc .
{"subject": ["3&&cả", "4&&2", "5&&chiếc", "6&&điện", "7&&thoại", "8&&này"], "object": ["3&&cả", "4&&2", "5&&chiếc", "6&&điện", "7&&thoại", "8&&này"], "aspect": ["16&&thiết", "17&&kế"], "predicate": ["9&&không", "10&&có", "11&&sự", "12&&khác", "13&&biệt", "14&&lớn"], "label": "EQL"}
{"subject": ["3&&cả", "4&&2", "5&&chiếc", "6&&điện", "7&&thoại", "8&&này"], "object": ["3&&cả", "4&&2", "5&&chiếc", "6&&điện", "7&&thoại", "8&&này"], "aspect": ["19&&màu", "20&&sắc"], "predicate": ["9&&không", "10&&có", "11&&sự", "12&&khác", "13&&biệt", "14&&lớn"], "label": "EQL"}

Cả 2 đều được sử dụng nhựa cao cấp cho mặt lưng và có khung viền bezel ở cạnh bên của máy.	Cả 2 đều được sử dụng nhựa cao cấp cho mặt lưng và có khung viền bezel ở cạnh bên của máy .

Galaxy A73 5G có kích thước máy lớn hơn và viền mỏng nhẹ hơn so với Galaxy A53 5G một chút.	Galaxy A73 5G có kích thước máy lớn hơn và viền mỏng nhẹ hơn so với Galaxy A53 5G một chút .
{"subject": ["1&&Galaxy", "2&&A73", "3&&5G"], "object": ["17&&Galaxy", "18&&A53", "19&&5G"], "aspect": ["5&&kích", "6&&thước", "7&&máy"], "predicate": ["8&&lớn", "9&&hơn"], "label": "COM+"}
{"subject": ["1&&Galaxy", "2&&A73", "3&&5G"], "object": ["17&&Galaxy", "18&&A53", "19&&5G"], "aspect": ["11&&viền"], "predicate": ["12&&mỏng", "13&&nhẹ", "14&&hơn"], "label": "COM+"}

Màu sắc của Galaxy A73 5G gồm trắng, đen, xanh bạc hà.	Màu sắc của Galaxy A73 5G gồm trắng , đen , xanh bạc hà .

Trong khi đó Galaxy A53 G5 có nhiều hơn một lựa chọn là: trắng, đen, cam và xanh dương.	Trong khi đó Galaxy A53 G5 có nhiều hơn một lựa chọn là : trắng , đen , cam và xanh dương .
{"subject": ["4&&Galaxy", "5&&A53", "6&&G5"], "object": [], "aspect": [], "predicate": ["8&&nhiều", "9&&hơn"], "label": "COM+"}

alt: sử dụng nhựa cao cấp cho mặt lưng và có khung viền bezel ở cạnh bên	alt : sử dụng nhựa cao cấp cho mặt lưng và có khung viền bezel ở cạnh bên

des: sử dụng nhựa cao cấp cho mặt lưng và có khung viền bezel ở cạnh bên	des : sử dụng nhựa cao cấp cho mặt lưng và có khung viền bezel ở cạnh bên

sử dụng nhựa cao cấp cho mặt lưng và có khung viền bezel ở cạnh bên.	sử dụng nhựa cao cấp cho mặt lưng và có khung viền bezel ở cạnh bên .

Màn hình	Màn hình

Đều được sử dụng màn hình có độ phân giải Full HD+ và  tần số quét 120Hz .	Đều được sử dụng màn hình có độ phân giải Full HD + và tần số quét 120Hz .
{"subject": [], "object": [], "aspect": ["5&&màn", "6&&hình", "7&&có", "8&&độ", "9&&phân", "10&&giải", "11&&Full", "12&&HD", "13&&+", "14&&và", "15&&tần", "16&&số", "17&&quét", "18&&120Hz"], "predicate": ["1&&Đều", "2&&được", "3&&sử", "4&&dụng"], "label": "EQL"}

Mặt trước của điện thoại đều được trang bị kính  cường lực Gorilla Glass  thế hệ thứ 5 giúp màn hình được bảo vệ và hạn chế trầy xước.	Mặt trước của điện thoại đều được trang bị kính cường lực Gorilla Glass thế hệ thứ 5 giúp màn hình được bảo vệ và hạn chế trầy xước .

Samsung Galaxy A53 được trang bị màn hình SUPER AMOLED với tỷ lệ khung hình là 20:9.	Samsung Galaxy A53 được trang bị màn hình SUPER AMOLED với tỷ lệ khung hình là 20 : 9 .

Trong khi đó, Samsung Galaxy A73 được ứng dụng công nghệ màn hình SUPER AMOLED+ kích thước lớn và sắc nét hơn với tỷ lệ tương tự.	Trong khi đó , Samsung Galaxy A73 được ứng dụng công nghệ màn hình SUPER AMOLED + kích thước lớn và sắc nét hơn với tỷ lệ tương tự .
{"subject": ["5&&Samsung", "6&&Galaxy", "7&&A73"], "object": [], "aspect": [], "predicate": ["22&&sắc", "23&&nét", "24&&hơn"], "label": "COM+"}
{"subject": ["5&&Samsung", "6&&Galaxy", "7&&A73"], "object": [], "aspect": ["26&&tỷ", "27&&lệ"], "predicate": ["28&&tương", "29&&tự"], "label": "EQL"}

alt: màn hình có độ phân giải Full HD+ và tần số quét 120Hz	alt : màn hình có độ phân giải Full HD + và tần số quét 120Hz

des: màn hình có độ phân giải Full HD+ và tần số quét 120Hz	des : màn hình có độ phân giải Full HD + và tần số quét 120Hz

màn hình có độ phân giải Full HD+ và tần số quét 120Hz.	màn hình có độ phân giải Full HD + và tần số quét 120Hz .

Camera	Camera

Cả 2 điện thoại đều sở hữu 4 ống kính như nhau.	Cả 2 điện thoại đều sở hữu 4 ống kính như nhau .
{"subject": ["1&&Cả", "2&&2", "3&&điện", "4&&thoại"], "object": ["1&&Cả", "2&&2", "3&&điện", "4&&thoại"], "aspect": ["8&&4", "9&&ống", "10&&kính"], "predicate": ["5&&đều", "6&&sở", "7&&hữu"], "label": "EQL"}

Tuy nhiên chúng vẫn có những điểm khác biệt như camera selfie của Galaxy A53 be shown so với A73 và các thông số camera cũng có sự khác biệt.	Tuy nhiên chúng vẫn có những điểm khác biệt như camera selfie của Galaxy A53 be shown so với A73 và các thông số camera cũng có sự khác biệt .
{"subject": ["14&&Galaxy", "15&&A53"], "object": ["20&&A73"], "aspect": ["22&&các", "23&&thông", "24&&số", "25&&camera"], "predicate": ["29&&khác", "30&&biệt"], "label": "DIF"}

Galaxy A53 có camera trước 32MP, ống kính chính 64MP, camera góc rộng đến 12 MP,  camera macro  và camera đo độ sâu 2MP.	Galaxy A53 có camera trước 32MP , ống kính chính 64MP , camera góc rộng đến 12 MP , camera macro và camera đo độ sâu 2MP .

Còn Galaxy A73 hiện đại hơn khi ống kính chính được nâng cấp đến 108 MP, camera macro và camera đo độ sâu đều là 5MP	Còn Galaxy A73 hiện đại hơn khi ống kính chính được nâng cấp đến 108 MP , camera macro và camera đo độ sâu đều là 5MP
{"subject": ["2&&Galaxy", "3&&A73"], "object": [], "aspect": ["8&&ống", "9&&kính", "10&&chính"], "predicate": ["4&&hiện", "5&&đại", "6&&hơn"], "label": "COM+"}

alt: Sở hữu 4 ống kính như nhau	alt : Sở hữu 4 ống kính như nhau

des: Sở hữu 4 ống kính như nhau	des : Sở hữu 4 ống kính như nhau

Sở hữu 4 ống kính như nhau.	Sở hữu 4 ống kính như nhau .

Hiệu năng	Hiệu năng

Chiếc điện thoại Galaxy A73 5G được nâng cấp con chip Snapdragon 778G giúp các tác vụ được xử lý mượt mà, đặc biệt là chơi game.	Chiếc điện thoại Galaxy A73 5G được nâng cấp con chip Snapdragon 778G giúp các tác vụ được xử lý mượt mà , đặc biệt là chơi game .

Bên cạnh đó, còn được trang bị thêm chip đồ họa Adreno 642L giúp khả năng hiển thị đồ họa tốc độ nhanh hơn.	Bên cạnh đó , còn được trang bị thêm chip đồ họa Adreno 642L giúp khả năng hiển thị đồ họa tốc độ nhanh hơn .

Samsung Galaxy A53 5G lại sở hữu vi xử lý Exynos 1280 mới với nhiều hiệu năng ấn tượng.	Samsung Galaxy A53 5G lại sở hữu vi xử lý Exynos 1280 mới với nhiều hiệu năng ấn tượng .

Ngoài ra chiếc điện thoại này cũng được trang bị thêm chip đồ họa  Mali-G68  được trang bị trên Galaxy A53 hỗ trợ quá trình chạy đồ họa mượt hơn	Ngoài ra chiếc điện thoại này cũng được trang bị thêm chip đồ họa Mali-G68 được trang bị trên Galaxy A53 hỗ trợ quá trình chạy đồ họa mượt hơn

alt: Galaxy A73 5G được nâng cấp con chip Snapdragon 778G	alt : Galaxy A73 5G được nâng cấp con chip Snapdragon 778G

des: Galaxy A73 5G được nâng cấp con chip Snapdragon 778G	des : Galaxy A73 5G được nâng cấp con chip Snapdragon 778G

Galaxy A73 5G được nâng cấp con chip Snapdragon 778G.	Galaxy A73 5G được nâng cấp con chip Snapdragon 778G .

Pin, sạc	Pin , sạc

Cả 2 đều sử dụng pin lõi Li-po dung lượng 5000mAh chỉ mất đến 70 phút là sạc đầy pin với công nghệ sạc nhanh  Super Fast Charging  25W.	Cả 2 đều sử dụng pin lõi Li-po dung lượng 5000mAh chỉ mất đến 70 phút là sạc đầy pin với công nghệ sạc nhanh Super Fast Charging 25W .
{"subject": ["1&&Cả", "2&&2"], "object": ["1&&Cả", "2&&2"], "aspect": ["6&&pin", "7&&lõi", "8&&Li-po", "9&&dung", "10&&lượng", "11&&5000mAh"], "predicate": ["3&&đều", "4&&sử", "5&&dụng"], "label": "EQL"}

Giờ đây bạn có thể tha hồ quay video hay chơi game mà không lo phải dành nhiều thời gian chờ pin được sạc đầy.	Giờ đây bạn có thể tha hồ quay video hay chơi game mà không lo phải dành nhiều thời gian chờ pin được sạc đầy .

alt: ả 2 đều sử dụng pin lõi Li-po dung lượng 5000mAh	alt : ả 2 đều sử dụng pin lõi Li-po dung lượng 5000mAh

des: ả 2 đều sử dụng pin lõi Li-po dung lượng 5000mAh	des : ả 2 đều sử dụng pin lõi Li-po dung lượng 5000mAh

ả 2 đều sử dụng pin lõi Li-po dung lượng 5000mAh.	ả 2 đều sử dụng pin lõi Li-po dung lượng 5000mAh .

Kết nối	Kết nối

Samsung Galaxy A53 và Samsung Galaxy A73 đều có khả năng kết nối mạng di động hỗ trợ 5G, 2  Nano SIM , Wi-Fi (Wi-Fi Direct, Wi-Fi hotspo, Dual-band 2.4 GHz/5 GHz), Wi-Fi 802.11 a/b/g/n/ac/ax), GPS, Bluetooth (A2D, PLE, v5.0), cổng Type - C, jack tai nghe Type - C.	Samsung Galaxy A53 và Samsung Galaxy A73 đều có khả năng kết nối mạng di động hỗ trợ 5G , 2 Nano SIM , Wi-Fi ( Wi-Fi Direct , Wi-Fi hotspo , Dual-band 2.4 GHz / 5 GHz ) , Wi-Fi 802.11 a / b / g / n / ac / ax ) , GPS , Bluetooth ( A2D , PLE , v5.0 ) , cổng Type - C , jack tai nghe Type - C .
{"subject": ["1&&Samsung", "2&&Galaxy", "3&&A53"], "object": ["5&&Samsung", "6&&Galaxy", "7&&A73"], "aspect": ["10&&khả", "11&&năng", "12&&kết", "13&&nối", "14&&mạng", "15&&di", "16&&động", "17&&hỗ", "18&&trợ", "19&&5G"], "predicate": ["8&&đều", "9&&có"], "label": "EQL"}

alt: đều có khả năng kết nối mạng di động hỗ trợ 5G, 2 Nano SIM, Wi-Fi	alt : đều có khả năng kết nối mạng di động hỗ trợ 5G , 2 Nano SIM , Wi-Fi

des: đều có khả năng kết nối mạng di động hỗ trợ 5G, 2 Nano SIM, Wi-Fi	des : đều có khả năng kết nối mạng di động hỗ trợ 5G , 2 Nano SIM , Wi-Fi

đều có khả năng kết nối mạng di động hỗ trợ 5G, 2 Nano SIM, Wi-Fi .	đều có khả năng kết nối mạng di động hỗ trợ 5G , 2 Nano SIM , Wi-Fi .

Tiện ích	Tiện ích

Cả 2 phiên bản Samsung này đều có các tiện ích tương tự nhau.	Cả 2 phiên bản Samsung này đều có các tiện ích tương tự nhau .
{"subject": ["1&&Cả", "2&&2", "3&&phiên", "4&&bản", "5&&Samsung", "6&&này"], "object": ["1&&Cả", "2&&2", "3&&phiên", "4&&bản", "5&&Samsung", "6&&này"], "aspect": ["9&&các", "10&&tiện", "11&&ích"], "predicate": ["12&&tương", "13&&tự", "14&&nhau"], "label": "EQL"}

Các chức năng cơ bản đều được hỗ trợ tối đa như xem phim, nghe nhạc, ghi âm.	Các chức năng cơ bản đều được hỗ trợ tối đa như xem phim , nghe nhạc , ghi âm .

Bên cạnh đó còn được trang bị tính năng mở khóa vân tay dưới màn hình nâng cao tính bảo mật và rất tiện lợi.	Bên cạnh đó còn được trang bị tính năng mở khóa vân tay dưới màn hình nâng cao tính bảo mật và rất tiện lợi .

Một số tính năng đặc biệt cũng có ở Galaxy A73 và Galaxxy A53 như chế độ trẻ em (Samsung Kids), tối ưu game (Game Booster), trợ lý ảo (Samsung Bixby), mở rộng bộ nhớ RAM,...	Một số tính năng đặc biệt cũng có ở Galaxy A73 và Galaxxy A53 như chế độ trẻ em ( Samsung Kids ) , tối ưu game ( Game Booster ) , trợ lý ảo ( Samsung Bixby ) , mở rộng bộ nhớ RAM , . . .

alt: Cả 2 phiên bản Samsung này ddefu có các tiện ích tương tự nhau	alt : Cả 2 phiên bản Samsung này ddefu có các tiện ích tương tự nhau

des: Cả 2 phiên bản Samsung này ddefu có các tiện ích tương tự nhau	des : Cả 2 phiên bản Samsung này ddefu có các tiện ích tương tự nhau

Cả 2 phiên bản Samsung này ddefu có các tiện ích tương tự nhau.	Cả 2 phiên bản Samsung này ddefu có các tiện ích tương tự nhau .

4.	4 .

Bảng so sánh	Bảng so sánh

5.	5 .

Nên mua Samsung Galaxy A53 hay A73?	Nên mua Samsung Galaxy A53 hay A73 ?

Nên mua Samsung Galaxy A53 hay A73 còn phụ thuộc vào nhu cầu và sở thích của người dùng vì mỗi chiếc điện thoại sẽ có những ưu điểm riêng.	Nên mua Samsung Galaxy A53 hay A73 còn phụ thuộc vào nhu cầu và sở thích của người dùng vì mỗi chiếc điện thoại sẽ có những ưu điểm riêng .

Samsung Galaxy A53 có thiết kế đẹp, cấu hình mạnh, chip xử lý Snapdragon 778G với hệ thống camrera được nâng cấp với ống kính chính lên tới 108MP.	Samsung Galaxy A53 có thiết kế đẹp , cấu hình mạnh , chip xử lý Snapdragon 778G với hệ thống camrera được nâng cấp với ống kính chính lên tới 108MP .

Những đặc điểm của chiếc điện thoại này rất phù hợp với những ai thích chụp ảnh mà chơi game.	Những đặc điểm của chiếc điện thoại này rất phù hợp với những ai thích chụp ảnh mà chơi game .

Còn với Samsung Galaxy A53 mặc dù có các hiệu năng và khả năng hiển thị thấp hơn nhưng vẫn đáp ứng đủ nhu cầu cho các bạn giống như Samsung Galaxy A73.	Còn với Samsung Galaxy A53 mặc dù có các hiệu năng và khả năng hiển thị thấp hơn nhưng vẫn đáp ứng đủ nhu cầu cho các bạn giống như Samsung Galaxy A73 .
{"subject": ["3&&Samsung", "4&&Galaxy", "5&&A53"], "object": ["31&&Samsung", "32&&Galaxy", "33&&A73"], "aspect": ["10&&hiệu", "11&&năng"], "predicate": ["17&&thấp", "18&&hơn"], "label": "COM-"}
{"subject": ["3&&Samsung", "4&&Galaxy", "5&&A53"], "object": ["31&&Samsung", "32&&Galaxy", "33&&A73"], "aspect": ["13&&khả", "14&&năng", "15&&hiển", "16&&thị"], "predicate": ["17&&thấp", "18&&hơn"], "label": "COM-"}
{"subject": ["3&&Samsung", "4&&Galaxy", "5&&A53"], "object": ["31&&Samsung", "32&&Galaxy", "33&&A73"], "aspect": ["21&&đáp", "22&&ứng", "23&&đủ", "24&&nhu", "25&&cầu"], "predicate": ["29&&giống", "30&&như"], "label": "EQL"}

Điểm cộng của A53 là kích thước nhỏ gọn hơn.	Điểm cộng của A53 là kích thước nhỏ gọn hơn .
{"subject": ["4&&A53"], "object": [], "aspect": ["6&&kích", "7&&thước"], "predicate": ["8&&nhỏ", "9&&gọn", "10&&hơn"], "label": "COM+"}

alt: Nên mua Samsung Galaxxy A53 hay A73 còn phụ thuộc vào nhu cầu và sở thích	alt : Nên mua Samsung Galaxxy A53 hay A73 còn phụ thuộc vào nhu cầu và sở thích

des: Nên mua Samsung Galaxxy A53 hay A73 còn phụ thuộc vào nhu cầu và sở thích	des : Nên mua Samsung Galaxxy A53 hay A73 còn phụ thuộc vào nhu cầu và sở thích

Nên mua Samsung Galaxxy A53 hay A73 còn phụ thuộc vào nhu cầu và sở thích.	Nên mua Samsung Galaxxy A53 hay A73 còn phụ thuộc vào nhu cầu và sở thích .

6.	6 .

Ưu đãi khi mua điện thoại Samsung tại TGDĐ	Ưu đãi khi mua điện thoại Samsung tại TGDĐ

alt: Thế giới di động	alt : Thế giới di động

des: Thế giới di động	des : Thế giới di động

Thế giới di động.	Thế giới di động .

Như vậy, thông qua bài viết trên TGDĐ đã giúp bạn so sánhđiện thoại Samsung Galaxy A53 và A73, máy nào tốt hơn?	Như vậy , thông qua bài viết trên TGDĐ đã giúp bạn so sánhđiện thoại Samsung Galaxy A53 và A73 , máy nào tốt hơn ?

Bạn thấy thông tin trên có bổ ích hay không?	Bạn thấy thông tin trên có bổ ích hay không ?

Đừng quên chia sẻ cho chúng tôi biết với nhé!	Đừng quên chia sẻ cho chúng tôi biết với nhé !

