title: So sánh điện thoại Samsung Galaxy A23 và A32, nên lựa chọn loại nào?	title : So sánh điện thoại Samsung Galaxy A23 và A32 , nên lựa chọn loại nào ?

Các sản phẩm  điện thoại  thông minh của Samsung luôn thu hút sự chú ý của giới yêu thích công nghệ.	Các sản phẩm điện thoại thông minh của Samsung luôn thu hút sự chú ý của giới yêu thích công nghệ .

Sau đây hãy cùng Thế Giới Di Động so sánh điện thoại  Samsung Galaxy A23  và  A32 , từ đó đưa ra quyết định nên lựa chọn loại nào nhé.	Sau đây hãy cùng Thế Giới Di Động so sánh điện thoại Samsung Galaxy A23 và A32 , từ đó đưa ra quyết định nên lựa chọn loại nào nhé .

1.	1 .

Tổng quan điện thoại Samsung Galaxy A23	Tổng quan điện thoại Samsung Galaxy A23

Xét về tổng quan, ngoại hình chiếc điện thoại này khá quen thuộc, song bên cạnh đó các góc máy cũng như cụm camera đều được bo cong.	Xét về tổng quan , ngoại hình chiếc điện thoại này khá quen thuộc , song bên cạnh đó các góc máy cũng như cụm camera đều được bo cong .

Ngoài ra, mặt trước của Galaxy A23 là màn hình với thiết kế Infinity-V để chứa camera selfie, mang đến trải nghiệm tràn viền ra các góc của máy.	Ngoài ra , mặt trước của Galaxy A23 là màn hình với thiết kế Infinity-V để chứa camera selfie , mang đến trải nghiệm tràn viền ra các góc của máy .

Vì vậy, dù máy có màn hình lên tới 6.6 inch nhưng khi cầm trên tay vẫn rất thoải mái.	Vì vậy , dù máy có màn hình lên tới 6.6 inch nhưng khi cầm trên tay vẫn rất thoải mái .

Con chip Snapdragon 680 đi kèm  RAM  4GB và bộ nhớ trong 128GB, hỗ trợ mở rộng bộ nhớ lên đến 1TB hoàn toàn có thể đáp ứng bạn chơi những tựa game hot, hay lướt web, xem phim thả ga.	Con chip Snapdragon 680 đi kèm RAM 4GB và bộ nhớ trong 128GB , hỗ trợ mở rộng bộ nhớ lên đến 1TB hoàn toàn có thể đáp ứng bạn chơi những tựa game hot , hay lướt web , xem phim thả ga .

alt: Thiết kế máy bo cong viền đem lại sự thoải mái khi cầm	alt : Thiết kế máy bo cong viền đem lại sự thoải mái khi cầm

des: Thiết kế máy bo cong viền đem lại sự thoải mái khi cầm	des : Thiết kế máy bo cong viền đem lại sự thoải mái khi cầm

Thiết kế máy bo cong viền đem lại sự thoải mái khi cầm.	Thiết kế máy bo cong viền đem lại sự thoải mái khi cầm .

2.	2 .

Tổng quan điện thoại Samsung Galaxy A32	Tổng quan điện thoại Samsung Galaxy A32

Hãng sản xuất Hàn Quốc này đã trang bị cho dòng điện thoại A32 màn hình giọt nước với viền mỏng hai bên ấn tượng, đem lại không gian hiển thị rộng rãi, sắc nét và chi tiết.	Hãng sản xuất Hàn Quốc này đã trang bị cho dòng điện thoại A32 màn hình giọt nước với viền mỏng hai bên ấn tượng , đem lại không gian hiển thị rộng rãi , sắc nét và chi tiết .

Hơn thế nữa, bộ bốn camera sau đến 64 MP hỗ trợ bắt trọn khoảnh khắc, người dùng có thể thỏa sức sáng tạo qua camera cảm biến độ sâu cùng 5 MP.	Hơn thế nữa , bộ bốn camera sau đến 64 MP hỗ trợ bắt trọn khoảnh khắc , người dùng có thể thỏa sức sáng tạo qua camera cảm biến độ sâu cùng 5 MP .

Mang trong mình sức mạnh của vi xử lý MediaTek Helio G80 8 nhân, chiếc A32 được cải tiến hiệu suất cao hơn so với các dòng thế hệ cũ.	Mang trong mình sức mạnh của vi xử lý MediaTek Helio G80 8 nhân , chiếc A32 được cải tiến hiệu suất cao hơn so với các dòng thế hệ cũ .
{"subject": ["16&&chiếc", "17&&A32"], "object": ["27&&các", "28&&dòng", "29&&thế", "30&&hệ", "31&&cũ"], "aspect": ["21&&hiệu", "22&&suất"], "predicate": ["23&&cao", "24&&hơn"], "label": "COM+"}

Kèm theo đó là hiệu năng vượt trội góp phần nâng cao trải nghiệm giải trí hay gaming được mượt mà, tối ưu nhất.	Kèm theo đó là hiệu năng vượt trội góp phần nâng cao trải nghiệm giải trí hay gaming được mượt mà , tối ưu nhất .

alt: Màn hình giọt nước do Samsung cải tiến trên điện thoại A32	alt : Màn hình giọt nước do Samsung cải tiến trên điện thoại A32

des: Màn hình giọt nước do Samsung cải tiến trên điện thoại A32	des : Màn hình giọt nước do Samsung cải tiến trên điện thoại A32

Màn hình giọt nước do Samsung cải tiến trên điện thoại A32.	Màn hình giọt nước do Samsung cải tiến trên điện thoại A32 .

3.	3 .

So sánh Samsung Galaxy A23 và A32	So sánh Samsung Galaxy A23 và A32

Thiết kế và màu sắc	Thiết kế và màu sắc

Về ngoại hình, cả hai sản phẩm đều được hoàn thiện nguyên khối với vỏ nhựa cứng cao cấp.	Về ngoại hình , cả hai sản phẩm đều được hoàn thiện nguyên khối với vỏ nhựa cứng cao cấp .
{"subject": ["5&&cả", "6&&hai", "7&&sản", "8&&phẩm"], "object": ["5&&cả", "6&&hai", "7&&sản", "8&&phẩm"], "aspect": ["2&&ngoại", "3&&hình"], "predicate": ["9&&đều", "10&&được", "11&&hoàn", "12&&thiện", "13&&nguyên", "14&&khối", "15&&với", "16&&vỏ", "17&&nhựa", "18&&cứng", "19&&cao", "20&&cấp"], "label": "EQL"}

Đây không chỉ là một cách giúp giảm giá thành sản phẩm mà còn giúp thiết bị nhẹ nhàng hơn.	Đây không chỉ là một cách giúp giảm giá thành sản phẩm mà còn giúp thiết bị nhẹ nhàng hơn .

Màu sắc của máy cũng được rõ nét hơn, có nhiều phiên bản màu lôi cuốn.	Màu sắc của máy cũng được rõ nét hơn , có nhiều phiên bản màu lôi cuốn .
{"subject": ["4&&máy"], "object": [], "aspect": ["1&&Màu", "2&&sắc"], "predicate": ["7&&rõ", "8&&nét", "9&&hơn"], "label": "COM+"}

alt: Samsung đã thay đổi sử dụng vỏ nhựa cho máy	alt : Samsung đã thay đổi sử dụng vỏ nhựa cho máy

des: Samsung đã thay đổi sử dụng vỏ nhựa cho máy	des : Samsung đã thay đổi sử dụng vỏ nhựa cho máy

Samsung đã thay đổi sử dụng vỏ nhựa cho máy.	Samsung đã thay đổi sử dụng vỏ nhựa cho máy .

Màn hình	Màn hình

Xét tới góc màn, trong khi màn hình của Samsung Galaxy A23 có kích thước 6.6 inch thì kích thước của màn hình Samsung A32 chỉ là 6.4 inch.	Xét tới góc màn , trong khi màn hình của Samsung Galaxy A23 có kích thước 6.6 inch thì kích thước của màn hình Samsung A32 chỉ là 6.4 inch .

Bên cạnh đó, chất lượng màn hình ở hai mức giá cũng được trang bị tấm nền khác nhau.	Bên cạnh đó , chất lượng màn hình ở hai mức giá cũng được trang bị tấm nền khác nhau .

Samsung A23 vẫn là dòng điện thoại giá rẻ nên chỉ được trang bị tấm nền PLS LCD với độ phân giải 1080 x 2408 pixels.	Samsung A23 vẫn là dòng điện thoại giá rẻ nên chỉ được trang bị tấm nền PLS LCD với độ phân giải 1080 x 2408 pixels .

Trong khi đó Samsung A32 thuộc phân khúc tầm trung khi mới ra mắt, sở hữu tấm nền Super AMOLED cao cấp với độ phân giải 1080 x 2400 pixels.	Trong khi đó Samsung A32 thuộc phân khúc tầm trung khi mới ra mắt , sở hữu tấm nền Super AMOLED cao cấp với độ phân giải 1080 x 2400 pixels .

Dù độ phân giải không chênh lệch mấy những vì kích thước Samsung A23 to hơn nên mất độ điểm ảnh chỉ khoảng 400 ppi.	Dù độ phân giải không chênh lệch mấy những vì kích thước Samsung A23 to hơn nên mất độ điểm ảnh chỉ khoảng 400 ppi .
{"subject": ["13&&Samsung", "14&&A23"], "object": [], "aspect": ["11&&kích", "12&&thước"], "predicate": ["15&&to", "16&&hơn"], "label": "COM"}
{"subject": [], "object": [], "aspect": ["2&&độ", "3&&phân", "4&&giải"], "predicate": ["5&&không", "6&&chênh", "7&&lệch", "8&&mấy"], "label": "EQL"}

alt: Độ phân giải ở hai dòng A23 và A32 có sự khác biệt	alt : Độ phân giải ở hai dòng A23 và A32 có sự khác biệt

des: Độ phân giải ở hai dòng A23 và A32 có sự khác biệt	des : Độ phân giải ở hai dòng A23 và A32 có sự khác biệt
{"subject": ["9&&A23"], "object": ["11&&A32"], "aspect": ["3&&Độ", "4&&phân", "5&&giải"], "predicate": ["12&&có", "13&&sự", "14&&khác", "15&&biệt"], "label": "DIF"}

Độ phân giải ở hai dòng A23 và A32 có sự khác biệt.	Độ phân giải ở hai dòng A23 và A32 có sự khác biệt .
{"subject": ["7&&A23"], "object": ["9&&A32"], "aspect": ["1&&Độ", "2&&phân", "3&&giải"], "predicate": ["10&&có", "11&&sự", "12&&khác", "13&&biệt"], "label": "DIF"}

Camera	Camera

Sự khác biệt giữa camera hai sản phẩm nằm ở chất lượng ống kính từng máy.	Sự khác biệt giữa camera hai sản phẩm nằm ở chất lượng ống kính từng máy .

Bản A32 với bộ 4 camera chất lượng bao gồm camera chính 64MP, camera siêu động 8Mp, camera macro 5MP và cảm biến chiều sâu 5MP cho phép người dùng chụp những bức ảnh cực kỳ chân thực, sắc nét và sinh động bất kể ngày hay đêm.	Bản A32 với bộ 4 camera chất lượng bao gồm camera chính 64MP , camera siêu động 8Mp , camera macro 5MP và cảm biến chiều sâu 5MP cho phép người dùng chụp những bức ảnh cực kỳ chân thực , sắc nét và sinh động bất kể ngày hay đêm .

Còn với A23 mới được ra mắt sau này, tuy có nhiều nâng cấp nhưng vẫn chưa thực sự vượt mặt được A32, chiếc điện thoại này chỉ sở hữu camera góc siêu rộng 50MP, với camera góc siêu rộng 5MP có góc chụp lên đến 123 độ, camera macro 2MP và cảm biến chiều sâu 2MP.	Còn với A23 mới được ra mắt sau này , tuy có nhiều nâng cấp nhưng vẫn chưa thực sự vượt mặt được A32 , chiếc điện thoại này chỉ sở hữu camera góc siêu rộng 50MP , với camera góc siêu rộng 5MP có góc chụp lên đến 123 độ , camera macro 2MP và cảm biến chiều sâu 2MP .
{"subject": ["3&&A23"], "object": ["24&&A32"], "aspect": [], "predicate": ["18&&chưa", "19&&thực", "20&&sự", "21&&vượt", "22&&mặt", "23&&được"], "label": "COM-"}

alt: Camera của A32 nhỉnh hơn về chất lượng	alt : Camera của A32 nhỉnh hơn về chất lượng

des: Camera của A32 nhỉnh hơn về chất lượng	des : Camera của A32 nhỉnh hơn về chất lượng
{"subject": ["3&&Camera", "4&&của", "5&&A32"], "object": [], "aspect": ["9&&chất", "10&&lượng"], "predicate": ["6&&nhỉnh", "7&&hơn"], "label": "COM+"}
{"subject": ["5&&A32"], "object": [], "aspect": ["3&&Camera"], "predicate": ["6&&nhỉnh", "7&&hơn", "8&&về", "9&&chất", "10&&lượng"], "label": "COM+"}

Camera của A32 nhỉnh hơn về chất lượng.	Camera của A32 nhỉnh hơn về chất lượng .
{"subject": ["1&&Camera", "2&&của", "3&&A32"], "object": [], "aspect": ["7&&chất", "8&&lượng"], "predicate": ["4&&nhỉnh", "5&&hơn"], "label": "COM+"}
{"subject": ["3&&A32"], "object": [], "aspect": ["1&&Camera"], "predicate": ["4&&nhỉnh", "5&&hơn", "6&&về", "7&&chất", "8&&lượng"], "label": "COM+"}

Hiệu năng	Hiệu năng

Đối với chip CPU, Samsung Galaxy A32 được trang bị bộ vi xử lý 8 nhân MediaTek Helio G80 mạnh mẽ có thể xử lý tốt các tác vụ, hoạt động trên nhiều nền tảng, thêm vào đó còn tối ưu tối ưu cho việc chơi game đem lại cảm giác thỏa mãn khi sử dụng.	Đối với chip CPU , Samsung Galaxy A32 được trang bị bộ vi xử lý 8 nhân MediaTek Helio G80 mạnh mẽ có thể xử lý tốt các tác vụ , hoạt động trên nhiều nền tảng , thêm vào đó còn tối ưu tối ưu cho việc chơi game đem lại cảm giác thỏa mãn khi sử dụng .

Ở vị trí bên kia, con chip “quốc dân” Qualcomm Snapdragon 680 trong chiếc A23 hoạt động tương thích hết sức mượt mà với màn hình 90Hz, ngoài ra còn có nhiều tính năng cao trong việc chơi game tránh những hiện tượng giật lag khi gia tăng tốc độ khung hình.	Ở vị trí bên kia , con chip “ quốc dân ” Qualcomm Snapdragon 680 trong chiếc A23 hoạt động tương thích hết sức mượt mà với màn hình 90Hz , ngoài ra còn có nhiều tính năng cao trong việc chơi game tránh những hiện tượng giật lag khi gia tăng tốc độ khung hình .

alt: Con chip	alt : Con chip

des: Con chip	des : Con chip

Con chip .	Con chip .

Pin, sạc	Pin , sạc

Xét về pin giữa A23 và A32 về dung lượng pin thì cả hai đều được trang bị viên pin có dung lượng khá lớn là 5000 mAh. Đây là dung lượng pin cao nhất được Samsung trang bị cho những dòng máy giá rẻ đến tầm trung.	Xét về pin giữa A23 và A32 về dung lượng pin thì cả hai đều được trang bị viên pin có dung lượng khá lớn là 5000 mAh . Đây là dung lượng pin cao nhất được Samsung trang bị cho những dòng máy giá rẻ đến tầm trung .
{"subject": ["13&&cả", "14&&hai"], "object": ["13&&cả", "14&&hai"], "aspect": ["9&&dung", "10&&lượng", "11&&pin"], "predicate": ["15&&đều", "16&&được", "17&&trang", "18&&bị", "19&&viên", "20&&pin", "21&&có", "22&&dung", "23&&lượng", "24&&khá", "25&&lớn", "26&&là", "27&&5000", "28&&mAh"], "label": "EQL"}
{"subject": ["13&&cả", "14&&hai"], "object": [], "aspect": ["32&&dung", "33&&lượng", "34&&pin"], "predicate": ["35&&cao", "36&&nhất", "37&&được", "38&&Samsung", "39&&trang", "40&&bị", "41&&cho", "42&&những", "43&&dòng", "44&&máy", "45&&giá", "46&&rẻ", "47&&đến", "48&&tầm", "49&&trung"], "label": "SUP+"}

Với dung lượng pin này người dùng có thể sử dụng đến hai ngày nếu sử dụng những tác vụ cơ bản.	Với dung lượng pin này người dùng có thể sử dụng đến hai ngày nếu sử dụng những tác vụ cơ bản .

Cả hai dòng máy này đều trang bị công nghệ sạc nhanh giúp người dùng được liên tục cập nhật mọi tin tức mới nhất.	Cả hai dòng máy này đều trang bị công nghệ sạc nhanh giúp người dùng được liên tục cập nhật mọi tin tức mới nhất .
{"subject": ["1&&Cả", "2&&hai", "3&&dòng", "4&&máy", "5&&này"], "object": ["1&&Cả", "2&&hai", "3&&dòng", "4&&máy", "5&&này"], "aspect": ["9&&công", "10&&nghệ", "11&&sạc", "12&&nhanh"], "predicate": ["6&&đều", "7&&trang", "8&&bị"], "label": "EQL"}

alt: Công nghệ sạc nhanh đem đến trải nghiệm dùng tốt hơn	alt : Công nghệ sạc nhanh đem đến trải nghiệm dùng tốt hơn

des: Công nghệ sạc nhanh đem đến trải nghiệm dùng tốt hơn	des : Công nghệ sạc nhanh đem đến trải nghiệm dùng tốt hơn

Công nghệ sạc nhanh đem đến trải nghiệm dùng tốt hơn.	Công nghệ sạc nhanh đem đến trải nghiệm dùng tốt hơn .

Kết nối	Kết nối

Vì là dòng điện thoại giá rẻ nên Samsung Galaxy A23 chưa được tích hợp băng tần 5G mà chỉ dừng lại ở kết nối 4G.	Vì là dòng điện thoại giá rẻ nên Samsung Galaxy A23 chưa được tích hợp băng tần 5G mà chỉ dừng lại ở kết nối 4G .

Trong khi đó, Samsung Galaxy A32 có cả phiên bản 4G và 5G, tuy nhiên phiên bản 5G là không được bán tại thị trường Việt Nam.	Trong khi đó , Samsung Galaxy A32 có cả phiên bản 4G và 5G , tuy nhiên phiên bản 5G là không được bán tại thị trường Việt Nam .

Nên ở khía cạnh này, hai thiết bị đều ở mức ngang nhau.	Nên ở khía cạnh này , hai thiết bị đều ở mức ngang nhau .
{"subject": ["7&&hai", "8&&thiết", "9&&bị"], "object": ["7&&hai", "8&&thiết", "9&&bị"], "aspect": ["3&&khía", "4&&cạnh", "5&&này"], "predicate": ["10&&đều", "11&&ở", "12&&mức", "13&&ngang", "14&&nhau"], "label": "EQL"}

alt: A23 chưa được tích hợp kết nối 5G	alt : A23 chưa được tích hợp kết nối 5G

des: A23 chưa được tích hợp kết nối 5G	des : A23 chưa được tích hợp kết nối 5G

A23 chưa được tích hợp kết nối 5G.	A23 chưa được tích hợp kết nối 5G .

Tiện ích	Tiện ích

Về cơ bản thì tiện ích được tích hợp trong cả hai sản phẩm không có nhiều sự khác biệt.	Về cơ bản thì tiện ích được tích hợp trong cả hai sản phẩm không có nhiều sự khác biệt .
{"subject": ["11&&cả", "12&&hai", "13&&sản", "14&&phẩm"], "object": ["11&&cả", "12&&hai", "13&&sản", "14&&phẩm"], "aspect": ["5&&tiện", "6&&ích"], "predicate": ["15&&không", "16&&có", "17&&nhiều", "18&&sự", "19&&khác", "20&&biệt"], "label": "EQL"}

Điểm nổi bật ở những chiếc điện thoại Samsung vẫn là bảo mật vân tay và tính năng nhận diện khuôn mặt.	Điểm nổi bật ở những chiếc điện thoại Samsung vẫn là bảo mật vân tay và tính năng nhận diện khuôn mặt .

alt: Cả hai dòng máy đều có tiện ích nổi bật của hãng	alt : Cả hai dòng máy đều có tiện ích nổi bật của hãng

des: Cả hai dòng máy đều có tiện ích nổi bật của hãng	des : Cả hai dòng máy đều có tiện ích nổi bật của hãng
{"subject": ["3&&Cả", "4&&hai", "5&&dòng", "6&&máy"], "object": ["3&&Cả", "4&&hai", "5&&dòng", "6&&máy"], "aspect": ["9&&tiện", "10&&ích", "11&&nổi", "12&&bật", "13&&của", "14&&hãng"], "predicate": ["7&&đều", "8&&có"], "label": "EQL"}

Cả hai dòng máy đều có tiện ích nổi bật của hãng.	Cả hai dòng máy đều có tiện ích nổi bật của hãng .
{"subject": ["1&&Cả", "2&&hai", "3&&dòng", "4&&máy"], "object": ["1&&Cả", "2&&hai", "3&&dòng", "4&&máy"], "aspect": ["7&&tiện", "8&&ích", "9&&nổi", "10&&bật", "11&&của", "12&&hãng"], "predicate": ["5&&đều", "6&&có"], "label": "EQL"}

4.	4 .

Bảng so sánh	Bảng so sánh

5.	5 .

Nên mua Samsung Galaxy A23 hay A32?	Nên mua Samsung Galaxy A23 hay A32 ?

Màn so kè giữa hai dòng sản phẩm này thực sự căng thẳng, nhất là khi Samsung A23 mới ra mắt mang nhiều nâng cấp so với thế hệ trước, đồng thời giá bán Samsung A32 đã hạ nhiệt đáng kể.	Màn so kè giữa hai dòng sản phẩm này thực sự căng thẳng , nhất là khi Samsung A23 mới ra mắt mang nhiều nâng cấp so với thế hệ trước , đồng thời giá bán Samsung A32 đã hạ nhiệt đáng kể .
{"subject": ["18&&Samsung", "19&&A23"], "object": ["29&&thế", "30&&hệ", "31&&trước"], "aspect": [], "predicate": ["23&&mang", "24&&nhiều", "25&&nâng", "26&&cấp"], "label": "COM+"}

Nhìn chung, đánh giá A32 có nhiều ưu điểm hơn, mặc dù đã ra mắt từ năm ngoái.	Nhìn chung , đánh giá A32 có nhiều ưu điểm hơn , mặc dù đã ra mắt từ năm ngoái .
{"subject": ["6&&A32"], "object": [], "aspect": [], "predicate": ["8&&nhiều", "9&&ưu", "10&&điểm", "11&&hơn"], "label": "COM+"}

Do đó, nếu cân nhắc đến một thiết bị tầm trung có dung lượng RAM cao, camera tốt hơn thì bạn có thể lựa chọn A32.	Do đó , nếu cân nhắc đến một thiết bị tầm trung có dung lượng RAM cao , camera tốt hơn thì bạn có thể lựa chọn A32 .
{"subject": ["28&&A32"], "object": [], "aspect": ["19&&camera"], "predicate": ["20&&tốt", "21&&hơn"], "label": "COM+"}

alt: Nên chọn mua loại máy nào để phù hợp nhu cầu hàng ngày	alt : Nên chọn mua loại máy nào để phù hợp nhu cầu hàng ngày

des: Nên chọn mua loại máy nào để phù hợp nhu cầu hàng ngày	des : Nên chọn mua loại máy nào để phù hợp nhu cầu hàng ngày

Nên chọn mua loại máy nào để phù hợp nhu cầu hàng ngày.	Nên chọn mua loại máy nào để phù hợp nhu cầu hàng ngày .

6.	6 .

Ưu đãi khi mua hàng tại TGDĐ	Ưu đãi khi mua hàng tại TGDĐ

alt: Yên tâm mua hàng tại Thế Giới Di Động	alt : Yên tâm mua hàng tại Thế Giới Di Động

des: Yên tâm mua hàng tại Thế Giới Di Động	des : Yên tâm mua hàng tại Thế Giới Di Động

Yên tâm mua hàng tại Thế Giới Di Động.	Yên tâm mua hàng tại Thế Giới Di Động .

Lưu ý : Bạn có thể cập nhật chi tiết chính sách bảo hành của Thế Giới Di Động  TẠI ĐÂY .	Lưu ý : Bạn có thể cập nhật chi tiết chính sách bảo hành của Thế Giới Di Động TẠI ĐÂY .

Hy vọng sau khi tham khảo bài viết này bạn đã có những thông tin về so sánh điện thoại Samsung Galaxy A23 và A32, nên lựa chọn loại nào.	Hy vọng sau khi tham khảo bài viết này bạn đã có những thông tin về so sánh điện thoại Samsung Galaxy A23 và A32 , nên lựa chọn loại nào .

Hẹn gặp lại bạn ở các bài viết sau!	Hẹn gặp lại bạn ở các bài viết sau !

