title: Đánh giá điện thoại Samsung Galaxy A24 vừa trình làng tại Việt Nam: Có đáng mua năm 2023?	title : Đánh giá điện thoại Samsung Galaxy A24 vừa trình làng tại Việt Nam : Có đáng mua năm 2023 ?

Nếu như bạn đang cân nhắc không biết có nên mua điện thoại Samsung Galaxy A24 hay không thì những thông tin dưới đây có thể giúp ích cho bạn.	Nếu như bạn đang cân nhắc không biết có nên mua điện thoại Samsung Galaxy A24 hay không thì những thông tin dưới đây có thể giúp ích cho bạn .

Samsung vừa mới bổ sung cho phân khúc smartphone giá 6 triệu đồng tại Việt Nam với dòng điện thoại Galaxy A24.	Samsung vừa mới bổ sung cho phân khúc smartphone giá 6 triệu đồng tại Việt Nam với dòng điện thoại Galaxy A24 .

Vậy liệu rằng với người tiêu dùng Việt Nam dòng điện thoại này có còn là lựa chọn tốt cho nhu cầu sử dụng hay không?	Vậy liệu rằng với người tiêu dùng Việt Nam dòng điện thoại này có còn là lựa chọn tốt cho nhu cầu sử dụng hay không ?

Cùng chúng tôi đánh giá và cho mình câu trả lời.	Cùng chúng tôi đánh giá và cho mình câu trả lời .

1. Đánh giá thiết kế điện thoại Samsung Galaxy A24	1 . Đánh giá thiết kế điện thoại Samsung Galaxy A24

Với điện thoại Samsung Galaxy A24 người sử dụng được sở hữu một chiếc điện thoại với thiết kế thời thượng lấy cảm hứng từ flagship Galaxy S23 series, đặc biệt là mặt lưng của máy gần như giống y hệ S23 tiêu chuẩn.	Với điện thoại Samsung Galaxy A24 người sử dụng được sở hữu một chiếc điện thoại với thiết kế thời thượng lấy cảm hứng từ flagship Galaxy S23 series , đặc biệt là mặt lưng của máy gần như giống y hệ S23 tiêu chuẩn .
{"subject": ["4&&Samsung", "5&&Galaxy", "6&&A24"], "object": ["42&&hệ", "43&&S23", "44&&tiêu", "45&&chuẩn"], "aspect": ["34&&mặt", "35&&lưng"], "predicate": ["38&&gần", "39&&như", "40&&giống", "41&&y"], "label": "EQL"}

alt: Đánh giá điện thoại Samsung Galaxy A24	alt : Đánh giá điện thoại Samsung Galaxy A24

des: Samsung Galaxy A24 vừa trình làng.	des : Samsung Galaxy A24 vừa trình làng .

Tại Việt Nam, Galaxy A24 được phân phối với 2 phiên bản màu sắc là màu đen và xanh.	Tại Việt Nam , Galaxy A24 được phân phối với 2 phiên bản màu sắc là màu đen và xanh .

Trong đo, phiên bản A24 màu đen được hoàn thiện nhám mang tới bề ngoài trung tính cao cấp, trong khi đó phiên bản A24 xanh lại được hoàn thiện với bề mặt bóng cùng hiệu ứng đổi màu theo góc nhìn đưa tới bề ngoài trẻ trung năng động.	Trong đo , phiên bản A24 màu đen được hoàn thiện nhám mang tới bề ngoài trung tính cao cấp , trong khi đó phiên bản A24 xanh lại được hoàn thiện với bề mặt bóng cùng hiệu ứng đổi màu theo góc nhìn đưa tới bề ngoài trẻ trung năng động .

Tùy phong cách mà người sử dụng có thể lựa chọn cho mình phiên bản màu Galaxy A24 phù hợp nhất.	Tùy phong cách mà người sử dụng có thể lựa chọn cho mình phiên bản màu Galaxy A24 phù hợp nhất .

Ở mặt trước điện thoại Galaxy A24 sở hữu màn hình tràn viền với camera trước cách điệu giọt nước mang tới không gian sử dụng khá thoải mái cho người sử dụng.	Ở mặt trước điện thoại Galaxy A24 sở hữu màn hình tràn viền với camera trước cách điệu giọt nước mang tới không gian sử dụng khá thoải mái cho người sử dụng .

Bên cạnh đó, điện thoại này cũng rất tiện dùng khi sử dụng khóa vân tay tích hợp vào nút nguồn giúp mở khóa màn hình dễ dàng hơn.	Bên cạnh đó , điện thoại này cũng rất tiện dùng khi sử dụng khóa vân tay tích hợp vào nút nguồn giúp mở khóa màn hình dễ dàng hơn .
{"subject": ["5&&điện", "6&&thoại", "7&&này"], "object": [], "aspect": ["24&&mở", "25&&khóa", "26&&màn", "27&&hình"], "predicate": ["28&&dễ", "29&&dàng", "30&&hơn"], "label": "COM+"}

Đồng thời việc duy trì jack tai nghe 3.5mm và sử dụng cổng sạc USB Type-C cũng mang tới cho người sử dụng nhiều tiện dụng khi sử dụng.	Đồng thời việc duy trì jack tai nghe 3.5mm và sử dụng cổng sạc USB Type-C cũng mang tới cho người sử dụng nhiều tiện dụng khi sử dụng .

Đáng tiếc là Samsung Galaxy A24 không được tích hợp khả năng kháng bụi nước.	Đáng tiếc là Samsung Galaxy A24 không được tích hợp khả năng kháng bụi nước .

2. Đánh giá chất lượng màn hình hiển thị của điện thoại Samsung Galaxy A24	2 . Đánh giá chất lượng màn hình hiển thị của điện thoại Samsung Galaxy A24

Samsung đưa tới cho Galaaxy A24 màn hình Super AMOLED 6,5 inch với độ phân giải 10880 x 2340 pixel đưa tới khả năng hiển thị sắc nét ấn tượng.	Samsung đưa tới cho Galaaxy A24 màn hình Super AMOLED 6,5 inch với độ phân giải 10880 x 2340 pixel đưa tới khả năng hiển thị sắc nét ấn tượng .

Và với độ sáng màn hình lên tới 1000 nit tối đa thì đây cũng là một trong những điện thoại có màn hình tốt nhất trong phân khúc giá bán.	Và với độ sáng màn hình lên tới 1000 nit tối đa thì đây cũng là một trong những điện thoại có màn hình tốt nhất trong phân khúc giá bán .
{"subject": ["14&&đây"], "object": [], "aspect": ["23&&màn", "24&&hình"], "predicate": ["25&&tốt", "26&&nhất", "27&&trong", "28&&phân", "29&&khúc", "30&&giá", "31&&bán"], "label": "SUP+"}

alt: Đánh giá điện thoại Samsung Galaxy A24	alt : Đánh giá điện thoại Samsung Galaxy A24

des: Samsung Galaxy A24 với màn hình xịn xò.	des : Samsung Galaxy A24 với màn hình xịn xò .

Đặc biệt, với tốc độ làm mới màn hình là 90Hz, mọi thao tác sử dụng trên màn hình đặc biệt là các chuyển động trong game trên màn hình của điện thoại Samsung Galaxy A24 cũng đều hết sức mượt mà.	Đặc biệt , với tốc độ làm mới màn hình là 90Hz , mọi thao tác sử dụng trên màn hình đặc biệt là các chuyển động trong game trên màn hình của điện thoại Samsung Galaxy A24 cũng đều hết sức mượt mà .

Đáng tiếc duy nhất là máy không có thiết kế camera nằm trong màn hình mà là thiết kế U-Infinity – đây là điều khiến điện thoại Samsung này có mặt trước trông hơi “giá rẻ” so với các điện thoại khác trong phân khúc như Xiaomi Redmi Note 12 chẳng hạn.	Đáng tiếc duy nhất là máy không có thiết kế camera nằm trong màn hình mà là thiết kế U-Infinity – đây là điều khiến điện thoại Samsung này có mặt trước trông hơi “ giá rẻ ” so với các điện thoại khác trong phân khúc như Xiaomi Redmi Note 12 chẳng hạn .
{"subject": ["26&&điện", "27&&thoại", "28&&Samsung", "29&&này"], "object": ["41&&các", "42&&điện", "43&&thoại", "44&&khác", "45&&trong", "46&&phân", "47&&khúc"], "aspect": ["31&&mặt", "32&&trước"], "predicate": ["33&&trông", "34&&hơi", "35&&“", "36&&giá", "37&&rẻ", "38&&”"], "label": "COM-"}
{"subject": ["26&&điện", "27&&thoại", "28&&Samsung", "29&&này"], "object": ["49&&Xiaomi", "50&&Redmi", "51&&Note", "52&&12"], "aspect": ["31&&mặt", "32&&trước"], "predicate": ["33&&trông", "34&&hơi", "35&&“", "36&&giá", "37&&rẻ", "38&&”"], "label": "COM-"}

3. Đánh giá hiệu năng xử lý của điện thoại Samsung Galaxy A24	3 . Đánh giá hiệu năng xử lý của điện thoại Samsung Galaxy A24

Samsung trang bị cho Galaxy A24 con chip MediaTek HeliO G99 được sản xuất trên tiến trình 6nm và là một trong những CPU mạnh m ẽ hàng đầu trong phân khúc tầm trung – giá rẻ trên thi trường hiện nay.	Samsung trang bị cho Galaxy A24 con chip MediaTek HeliO G99 được sản xuất trên tiến trình 6nm và là một trong những CPU mạnh m ẽ hàng đầu trong phân khúc tầm trung – giá rẻ trên thi trường hiện nay .
{"subject": ["9&&MediaTek", "10&&HeliO", "11&&G99"], "object": [], "aspect": [], "predicate": ["25&&mạnh", "26&&m", "27&&ẽ", "28&&hàng", "29&&đầu", "30&&trong", "31&&phân", "32&&khúc", "33&&tầm", "34&&trung", "35&&–", "36&&giá", "37&&rẻ", "38&&trên", "39&&thi", "40&&trường", "41&&hiện", "42&&nay"], "label": "SUP+"}

alt: Đánh giá điện thoại Samsung Galaxy A24	alt : Đánh giá điện thoại Samsung Galaxy A24

des: Samsung Galaxy A24 sở hữu cấu hình mạnh mẽ.	des : Samsung Galaxy A24 sở hữu cấu hình mạnh mẽ .

Tại Việt Nam, Galaxy A24 được bán kèm RAM tùy chọn 6GB hoặc 8GB đi kèm với bộ nhớ trong 128GB.	Tại Việt Nam , Galaxy A24 được bán kèm RAM tùy chọn 6GB hoặc 8GB đi kèm với bộ nhớ trong 128GB .

Người sử dụng cũng có thể mở rộng bộ nhớ của điện thoại này bằng cách gắn thêm thẻ nhớ microSD.	Người sử dụng cũng có thể mở rộng bộ nhớ của điện thoại này bằng cách gắn thêm thẻ nhớ microSD .

Về phần mềm máy được cài sẵn hệ điều hành Android 13 với tùy biến giao diện OneUI 5.1 đưa tới những trải nghiệm hiện đại nhất cho người sử dụng.	Về phần mềm máy được cài sẵn hệ điều hành Android 13 với tùy biến giao diện OneUI 5.1 đưa tới những trải nghiệm hiện đại nhất cho người sử dụng .

Dưới đây là điểm hiệu năng của A24 trên một số thang đo hiệu năng uy tín nhất hiện nay:	Dưới đây là điểm hiệu năng của A24 trên một số thang đo hiệu năng uy tín nhất hiện nay :

– Trên Geekbench 5: điểm đơn nhân là 563, điểm đa nhân là 1951 điểm	– Trên Geekbench 5 : điểm đơn nhân là 563 , điểm đa nhân là 1951 điểm

– Trên Antutu 9: máy đạt điểm tổng thể là 361159	– Trên Antutu 9 : máy đạt điểm tổng thể là 361159

Điểm hiệu năng này nếu so sánh với các smartphone khác trong phân khúc thuộc hàng rất tốt.	Điểm hiệu năng này nếu so sánh với các smartphone khác trong phân khúc thuộc hàng rất tốt .
{"subject": [], "object": ["9&&các", "10&&smartphone", "11&&khác", "12&&trong", "13&&phân", "14&&khúc"], "aspect": ["1&&Điểm", "2&&hiệu", "3&&năng", "4&&này"], "predicate": ["15&&thuộc", "16&&hàng", "17&&rất", "18&&tốt"], "label": "COM+"}

Điều này giúp máy có được khả năng xử lý tốt các game mobile phổ biến như Liên Quân Mobile, PUBG Mobile…	Điều này giúp máy có được khả năng xử lý tốt các game mobile phổ biến như Liên Quân Mobile , PUBG Mobile …

Thỏi pin 5000 mAh của A24 cũng làm việc rất tốt để đưa tới thời lượng sử dụng máy thoải mái cả ngày dài cho người sử dụng.	Thỏi pin 5000 mAh của A24 cũng làm việc rất tốt để đưa tới thời lượng sử dụng máy thoải mái cả ngày dài cho người sử dụng .

Và công nghệ sạc nhanh 25W cũng giúp tiết kiệm đáng kể thời gian sạc.	Và công nghệ sạc nhanh 25W cũng giúp tiết kiệm đáng kể thời gian sạc .

4. Đánh giá camera trên điện thoại Samsung Galaxy A24	4 . Đánh giá camera trên điện thoại Samsung Galaxy A24

Điện thoại A24 sở hữu cụm camera chính bao gồm 3 ống kính gồm cảm biến chính góc rộng 50MP, cảm biến góc siêu rộng 5MP và cảm biến macro 2MP.	Điện thoại A24 sở hữu cụm camera chính bao gồm 3 ống kính gồm cảm biến chính góc rộng 50MP , cảm biến góc siêu rộng 5MP và cảm biến macro 2MP .

Với trang bị này, điện thoại A24 có được khả năng đưa tới những bức ảnh với độ sắc nét ấn tượng đi kèm với đó là người sử dụng có thể chụp đa dạng các loại ảnh khác nhau để đáp ứng nhu cầu lưu dữ khoảnh khắc cuộc sống.	Với trang bị này , điện thoại A24 có được khả năng đưa tới những bức ảnh với độ sắc nét ấn tượng đi kèm với đó là người sử dụng có thể chụp đa dạng các loại ảnh khác nhau để đáp ứng nhu cầu lưu dữ khoảnh khắc cuộc sống .

alt: Đánh giá điện thoại Samsung Galaxy A24	alt : Đánh giá điện thoại Samsung Galaxy A24

des: Samsung Galaxy A24 sở hữu cụm 3 camera.	des : Samsung Galaxy A24 sở hữu cụm 3 camera .

Bên cạnh đó, camera trước 13MP cũng đưa tới một công cụ selfie đỉnh cao với sự sắc nét và nhiều chế độ làm đẹp giúp mang tới sự hài lòng cho người sử dụng.	Bên cạnh đó , camera trước 13MP cũng đưa tới một công cụ selfie đỉnh cao với sự sắc nét và nhiều chế độ làm đẹp giúp mang tới sự hài lòng cho người sử dụng .

KẾT LUẬN	KẾT LUẬN

Với giá bán từ 6 triệu đồng trên thị trường hiện nay cùng với loạt các trang bị ấn tượng chúng tôi đề cập trên đâ thì Galaxy A24 không chỉ mang tới smartphone có bề ngoài thời thượng, mà khả năng chụp hình, cấu hình lẫn màn hình đều thuộc hàng tốt nhất, đáp ứng nhu cầu sử dụng của người dùng phổ thông.	Với giá bán từ 6 triệu đồng trên thị trường hiện nay cùng với loạt các trang bị ấn tượng chúng tôi đề cập trên đâ thì Galaxy A24 không chỉ mang tới smartphone có bề ngoài thời thượng , mà khả năng chụp hình , cấu hình lẫn màn hình đều thuộc hàng tốt nhất , đáp ứng nhu cầu sử dụng của người dùng phổ thông .
{"subject": ["28&&Galaxy", "29&&A24"], "object": [], "aspect": ["42&&khả", "43&&năng", "44&&chụp", "45&&hình"], "predicate": ["53&&thuộc", "54&&hàng", "55&&tốt", "56&&nhất"], "label": "SUP+"}
{"subject": ["28&&Galaxy", "29&&A24"], "object": [], "aspect": ["47&&cấu", "48&&hình"], "predicate": ["53&&thuộc", "54&&hàng", "55&&tốt", "56&&nhất"], "label": "SUP+"}
{"subject": ["28&&Galaxy", "29&&A24"], "object": [], "aspect": ["50&&màn", "51&&hình"], "predicate": ["53&&thuộc", "54&&hàng", "55&&tốt", "56&&nhất"], "label": "SUP+"}

Do đó, nếu như bạn đang cần mua điện thoại trong tầm giá 6 triệu đồng trên thị trường thì chắc chắn model Galaxy A24 sẽ là lựa chọn “đáng đồng tiền bát gạo” dành cho bạn.	Do đó , nếu như bạn đang cần mua điện thoại trong tầm giá 6 triệu đồng trên thị trường thì chắc chắn model Galaxy A24 sẽ là lựa chọn “ đáng đồng tiền bát gạo ” dành cho bạn .

