title: Đánh giá Samsung Galaxy A24: Camera 50 MP cùng chip MediaTek Helio G99	title : Đánh giá Samsung Galaxy A24 : Camera 50 MP cùng chip MediaTek Helio G99

Nói đến  điện thoại thông minh  không thể không nói đến  điện thoại Samsung .	Nói đến điện thoại thông minh không thể không nói đến điện thoại Samsung .

Mới ngay đây Samsung đã cho ra mắt sản phẩm mới của hãng thuộc dòng  Samsung Galaxy A .	Mới ngay đây Samsung đã cho ra mắt sản phẩm mới của hãng thuộc dòng Samsung Galaxy A .

Đến với bài viết đánh giá  Samsung Galaxy A24 , cùng xem sản phẩm mới này có gì nổi bật.	Đến với bài viết đánh giá Samsung Galaxy A24 , cùng xem sản phẩm mới này có gì nổi bật .

1.	1 .

Tổng quan về điện thoại Samsung Galaxy A24	Tổng quan về điện thoại Samsung Galaxy A24

Mới ngay đây 24/04, Samsung đã cho ra mắt sản phẩm mới thuộc phân khúc điện thoại tầm trung là Samsung Galaxy A24 với 2 phiên bản bộ nhớ lần lượt là  Samsung A24 6GB  và 8GB.	Mới ngay đây 24 / 04 , Samsung đã cho ra mắt sản phẩm mới thuộc phân khúc điện thoại tầm trung là Samsung Galaxy A24 với 2 phiên bản bộ nhớ lần lượt là Samsung A24 6GB và 8GB .

Phiên bản màu sắc cũng được hãng công bố với 4 màu bao gồm đen, xanh lá, bạc và đỏ.	Phiên bản màu sắc cũng được hãng công bố với 4 màu bao gồm đen , xanh lá , bạc và đỏ .

Sản phẩm rất được đầu tư khi được trang bị bộ 3 camera sau đầy hiện đại, bộ vi xử lý mạnh mẽ với khả năng đa nhiệm tuyệt vời thêm nữa là màn hình với chất lượng hiển thị sắc nét và vô số những tính năng hiện đại khác.	Sản phẩm rất được đầu tư khi được trang bị bộ 3 camera sau đầy hiện đại , bộ vi xử lý mạnh mẽ với khả năng đa nhiệm tuyệt vời thêm nữa là màn hình với chất lượng hiển thị sắc nét và vô số những tính năng hiện đại khác .

alt: Cùng xem ngay Samsung Galaxy A24 vừa ra mắt với những công nghệ hiện đại	alt : Cùng xem ngay Samsung Galaxy A24 vừa ra mắt với những công nghệ hiện đại

des: Cùng xem ngay Samsung Galaxy A24 vừa ra mắt với những công nghệ hiện đại	des : Cùng xem ngay Samsung Galaxy A24 vừa ra mắt với những công nghệ hiện đại

2.	2 .

Những điểm nổi bật trên điện thoại Samsung Galaxy A24	Những điểm nổi bật trên điện thoại Samsung Galaxy A24

Thiết kế hiện đại với diện mạo đặc trưng dòng A	Thiết kế hiện đại với diện mạo đặc trưng dòng A

Sản phẩm Samsung Galaxy A24 được kế thừa những đường nét thiết kế từ dòng Galaxy A của Samsung.	Sản phẩm Samsung Galaxy A24 được kế thừa những đường nét thiết kế từ dòng Galaxy A của Samsung .
{"subject": ["3&&Samsung", "4&&Galaxy", "5&&A24"], "object": ["15&&dòng", "16&&Galaxy", "17&&A", "18&&của", "19&&Samsung"], "aspect": ["9&&những", "10&&đường", "11&&nét", "12&&thiết", "13&&kế"], "predicate": ["6&&được", "7&&kế", "8&&thừa"], "label": "EQL"}

Máy sở hữu bộ khung vuông vắn và phần mặt lưng được vát phẳng, 4 góc cũng được bo tròn để người dùng cũng có thề thoải mái sử dụng hơn.	Máy sở hữu bộ khung vuông vắn và phần mặt lưng được vát phẳng , 4 góc cũng được bo tròn để người dùng cũng có thề thoải mái sử dụng hơn .

Giống với các sản phẩm thuộc dòng Galaxy A, khung viền quanh máy sử dụng chất liệu nhựa giúp khối lượng máy nhẹ hơn.	Giống với các sản phẩm thuộc dòng Galaxy A , khung viền quanh máy sử dụng chất liệu nhựa giúp khối lượng máy nhẹ hơn .
{"subject": [], "object": ["3&&các", "4&&sản", "5&&phẩm", "6&&thuộc", "7&&dòng", "8&&Galaxy", "9&&A"], "aspect": ["11&&khung", "12&&viền", "13&&quanh", "14&&máy"], "predicate": ["1&&Giống", "2&&với"], "label": "EQL"}

Hơn nữa kích thước của máy cũng vừa vặn không quá to phù hợp cho mọi đối tượng kể cả nam và nữ đều sử dụng được.	Hơn nữa kích thước của máy cũng vừa vặn không quá to phù hợp cho mọi đối tượng kể cả nam và nữ đều sử dụng được .

Các phiên bản màu sắc gồm có đen, xanh lá, bạc, đỏ những màu này đều làm toát lên vẻ hiện đại, trẻ trung và thời trang cho cả sản phẩm lẫn người dùng.	Các phiên bản màu sắc gồm có đen , xanh lá , bạc , đỏ những màu này đều làm toát lên vẻ hiện đại , trẻ trung và thời trang cho cả sản phẩm lẫn người dùng .

alt: Diện mạo của sản phẩm thừa hưởng những thiết kế hiện đại và độc đáo từ dòng Galaxy A	alt : Diện mạo của sản phẩm thừa hưởng những thiết kế hiện đại và độc đáo từ dòng Galaxy A

des: Diện mạo của sản phẩm thừa hưởng những thiết kế hiện đại và độc đáo từ dòng Galaxy A	des : Diện mạo của sản phẩm thừa hưởng những thiết kế hiện đại và độc đáo từ dòng Galaxy A

Tấm nền  Super AMOLED  giúp các hình ảnh trở nên sống động, chân thực hơn.	Tấm nền Super AMOLED giúp các hình ảnh trở nên sống động , chân thực hơn .
{"subject": ["1&&Tấm", "2&&nền", "3&&Super", "4&&AMOLED"], "object": [], "aspect": ["7&&hình", "8&&ảnh"], "predicate": ["11&&sống", "12&&động", "13&&,", "14&&chân", "15&&thực", "16&&hơn"], "label": "COM+"}

Bên cạnh đó nó còn giúp máy tiết kiệm điện năng và bảo vệ mắt của người dùng nhờ việc giảm thiểu ánh sáng xanh.	Bên cạnh đó nó còn giúp máy tiết kiệm điện năng và bảo vệ mắt của người dùng nhờ việc giảm thiểu ánh sáng xanh .

Tần số quét 90Hz  mang đến khả năng cuộn lướt vô cùng mượt mà.	Tần số quét 90Hz mang đến khả năng cuộn lướt vô cùng mượt mà .

Thêm nữa, nữa người dùng có thể chạm 2 lần lên màn hình để kích hoạt màn hình chờ, đây là một tính năng khá hữu ích được tích hợp trên màn hình máy.	Thêm nữa , nữa người dùng có thể chạm 2 lần lên màn hình để kích hoạt màn hình chờ , đây là một tính năng khá hữu ích được tích hợp trên màn hình máy .

alt: Màn hình Samsung Galaxy A24 được trang bị các công nghệ cùng tính năng hiện đại	alt : Màn hình Samsung Galaxy A24 được trang bị các công nghệ cùng tính năng hiện đại

des: Màn hình Samsung Galaxy A24 được trang bị các công nghệ cùng tính năng hiện đại	des : Màn hình Samsung Galaxy A24 được trang bị các công nghệ cùng tính năng hiện đại

Camera 50MP với nhiều tính năng chụp ảnh đẹp	Camera 50MP với nhiều tính năng chụp ảnh đẹp

Bộ 3 camera được trang bị với camera chính lên đến 50MP và 2 camera phụ lần lượt là 5MP và 2MP phục vụ đa dạng nhu cầu chụp ảnh, quay video của người dùng.	Bộ 3 camera được trang bị với camera chính lên đến 50MP và 2 camera phụ lần lượt là 5MP và 2MP phục vụ đa dạng nhu cầu chụp ảnh , quay video của người dùng .

Với ống kính chính có độ phân giải cao, sản phẩm tự tin sẽ mang đến những hình ảnh với độ chân thực, chi tiết và chất lượng đáp ứng được mọi yêu cầu từ chủ sở hữu.	Với ống kính chính có độ phân giải cao , sản phẩm tự tin sẽ mang đến những hình ảnh với độ chân thực , chi tiết và chất lượng đáp ứng được mọi yêu cầu từ chủ sở hữu .

Không chỉ có camera xịn xò, vô số các tính năng hiện đại khác cũng được tích hợp trên máy có thể kể đến như  AI Camera ,  Làm đẹp ,  Chống rung quang học (OIS) ,  Tự động lấy nét (AF) ,... Điều này sẽ giúp tăng lên đáng kể chất lượng những khung hình hay video thu được.	Không chỉ có camera xịn xò , vô số các tính năng hiện đại khác cũng được tích hợp trên máy có thể kể đến như AI Camera , Làm đẹp , Chống rung quang học ( OIS ) , Tự động lấy nét ( AF ) , . . . Điều này sẽ giúp tăng lên đáng kể chất lượng những khung hình hay video thu được .

alt: Bộ camera sau hiện đại với cho ra những khung hình và video đầy chất lượng	alt : Bộ camera sau hiện đại với cho ra những khung hình và video đầy chất lượng

des: Bộ camera sau hiện đại với cho ra những khung hình và video đầy chất lượng	des : Bộ camera sau hiện đại với cho ra những khung hình và video đầy chất lượng

Hiệu năng ổn định với chip MediaTek Helio G99	Hiệu năng ổn định với chip MediaTek Helio G99

Bộ xử lý của Samsung Galay A24 được trang bị con chip MediaTek Helio G99 được đánh giá khá cao trong phân khúc điện thoại tầm trung - giá rẻ.	Bộ xử lý của Samsung Galay A24 được trang bị con chip MediaTek Helio G99 được đánh giá khá cao trong phân khúc điện thoại tầm trung - giá rẻ .

Với hiệu suất tối đa đạt 2.2Ghz, máy có thể tự tin xử lý các tác vụ một cách gọn gàng và mang đến trải nghiệm giải trí mượt mà không giật lag.	Với hiệu suất tối đa đạt 2.2Ghz , máy có thể tự tin xử lý các tác vụ một cách gọn gàng và mang đến trải nghiệm giải trí mượt mà không giật lag .

Hơn nữa, thanh  RAM  của sản phẩm cũng có dung lượng khá cao (6GB, 8GB).	Hơn nữa , thanh RAM của sản phẩm cũng có dung lượng khá cao ( 6GB , 8GB ) .

Nhờ đó khả năng đa nhiệm hay chuyển đổi tác vụ sẽ được đảm bảo hoạt động một cách trơn tru, uyển chuyển hạn chế tối đa tình trạng bị đơ, đứng máy.	Nhờ đó khả năng đa nhiệm hay chuyển đổi tác vụ sẽ được đảm bảo hoạt động một cách trơn tru , uyển chuyển hạn chế tối đa tình trạng bị đơ , đứng máy .

alt: Con chip MediaTek Helio G99 mang đến hiệu năng mạnh mẽ cho thiết bị	alt : Con chip MediaTek Helio G99 mang đến hiệu năng mạnh mẽ cho thiết bị

des: Con chip MediaTek Helio G99 mang đến hiệu năng mạnh mẽ cho thiết bị	des : Con chip MediaTek Helio G99 mang đến hiệu năng mạnh mẽ cho thiết bị

Không gian lưu trữ rộng lớn	Không gian lưu trữ rộng lớn

Theo thông số, bộ nhớ trong của sản phẩm là 128GB trong đó bộ nhớ khả dụng là khoảng 113GB.	Theo thông số , bộ nhớ trong của sản phẩm là 128GB trong đó bộ nhớ khả dụng là khoảng 113GB .

Với con số này thì người dùng có thể thoải mái lưu trữ các thông tin, dữ liệu quan trọng của bản thân mà không cần lo việc bị hết bộ nhớ.	Với con số này thì người dùng có thể thoải mái lưu trữ các thông tin , dữ liệu quan trọng của bản thân mà không cần lo việc bị hết bộ nhớ .

Và như đã đề cập, thanh RAM của máy cũng sở hữu dung lượng không hề nhỏ.	Và như đã đề cập , thanh RAM của máy cũng sở hữu dung lượng không hề nhỏ .

Điều này sẽ giúp tốc độ truy xuất dữ liệu ứng dụng của máy được đảm bảo, từ đó giúp máy hoạt động ổn định và mượt mà.	Điều này sẽ giúp tốc độ truy xuất dữ liệu ứng dụng của máy được đảm bảo , từ đó giúp máy hoạt động ổn định và mượt mà .

alt: Sản phẩm sở hữu dung lượng bộ nhớ khổng lồ hỗ trợ tối đa việc lưu trữ dữ liệu cho người dùng	alt : Sản phẩm sở hữu dung lượng bộ nhớ khổng lồ hỗ trợ tối đa việc lưu trữ dữ liệu cho người dùng

des: Sản phẩm sở hữu dung lượng bộ nhớ khổng lồ hỗ trợ tối đa việc lưu trữ dữ liệu cho người dùng	des : Sản phẩm sở hữu dung lượng bộ nhớ khổng lồ hỗ trợ tối đa việc lưu trữ dữ liệu cho người dùng

Viên pin 5000 mAh cho thời lượng sử dụng lâu hơn	Viên pin 5000 mAh cho thời lượng sử dụng lâu hơn
{"subject": ["1&&Viên", "2&&pin", "3&&5000", "4&&mAh"], "object": [], "aspect": ["6&&thời", "7&&lượng", "8&&sử", "9&&dụng"], "predicate": ["10&&lâu", "11&&hơn"], "label": "COM+"}

Với việc trang bị viên pin 5000mAh, Samsung có tự tin đảm bảo sản phẩm của mình sẽ có thể hoạt động trong cả một ngày dài với nhiều tác vụ khác nhau.	Với việc trang bị viên pin 5000mAh , Samsung có tự tin đảm bảo sản phẩm của mình sẽ có thể hoạt động trong cả một ngày dài với nhiều tác vụ khác nhau .

Thậm chí nếu chỉ dùng điện thoại cho các nhu cầu cơ bản quãng thời gian này có thể kéo dài đến 2-3 ngày.	Thậm chí nếu chỉ dùng điện thoại cho các nhu cầu cơ bản quãng thời gian này có thể kéo dài đến 2 - 3 ngày .

Không chỉ thế, sản phẩm còn hỗ trợ sạc tối đa 25W cùng với công nghệ  sạc pin nhanh  được tích hợp.	Không chỉ thế , sản phẩm còn hỗ trợ sạc tối đa 25W cùng với công nghệ sạc pin nhanh được tích hợp .

Vì thế, chỉ tốn khoảng 1 giờ, thiết bị có thể lại được nạp đầy năng lượng.	Vì thế , chỉ tốn khoảng 1 giờ , thiết bị có thể lại được nạp đầy năng lượng .

Điều này mang đến một trải nghiệm liên tục cho người dùng.	Điều này mang đến một trải nghiệm liên tục cho người dùng .

alt: Viên pin khủng cùng chế độ sạc nhanh giúp người dùng có thể liên tục sử dụng thiết bị mà không bị gián đoạn	alt : Viên pin khủng cùng chế độ sạc nhanh giúp người dùng có thể liên tục sử dụng thiết bị mà không bị gián đoạn

des: Viên pin khủng cùng chế độ sạc nhanh giúp người dùng có thể liên tục sử dụng thiết bị mà không bị gián đoạn	des : Viên pin khủng cùng chế độ sạc nhanh giúp người dùng có thể liên tục sử dụng thiết bị mà không bị gián đoạn

3.	3 .

Điện thoại Samsung Galaxy A24 có tốt không?	Điện thoại Samsung Galaxy A24 có tốt không ?

Có nên mua không?	Có nên mua không ?

Phía trên, ta đã lần lượt đánh giá các mặt của sản phẩm mới ra mắt nhà Samsung.	Phía trên , ta đã lần lượt đánh giá các mặt của sản phẩm mới ra mắt nhà Samsung .

Thiết kế cuốn hút, bộ camera hiện đại, màn hình cao cấp, hiệu năng mạnh mẽ và khả năng vận hành bền bỉ.	Thiết kế cuốn hút , bộ camera hiện đại , màn hình cao cấp , hiệu năng mạnh mẽ và khả năng vận hành bền bỉ .

Đây rõ ràng là một sản phẩm điện thoại tầm trung - giá rẻ đầy chất lượng và đáng sở hữu.	Đây rõ ràng là một sản phẩm điện thoại tầm trung - giá rẻ đầy chất lượng và đáng sở hữu .

Nếu bạn là học sinh - sinh viên hay những người chỉ có nhu cầu xử lý các tác vụ cơ bản, giải trí vừa phải như xem video, chơi các tựa game nhẹ,... thì mẫu điện thoại này có thể đáp ứng mọi yêu cầu của bạn một cách hoàn hảo nhất.	Nếu bạn là học sinh - sinh viên hay những người chỉ có nhu cầu xử lý các tác vụ cơ bản , giải trí vừa phải như xem video , chơi các tựa game nhẹ , . . . thì mẫu điện thoại này có thể đáp ứng mọi yêu cầu của bạn một cách hoàn hảo nhất .

alt: Một mẫu điện thoại tầm trung giúp học tập, làm việc dễ dàng	alt : Một mẫu điện thoại tầm trung giúp học tập , làm việc dễ dàng

des: Một mẫu điện thoại tầm trung giúp học tập, làm việc dễ dàng	des : Một mẫu điện thoại tầm trung giúp học tập , làm việc dễ dàng

4.	4 .

Giá bán điện thoại Samsung Galaxy A24	Giá bán điện thoại Samsung Galaxy A24

5.	5 .

Ưu đãi/bảo hành khi mua điện thoại Samsung Galaxy A24 tại TGDĐ	Ưu đãi / bảo hành khi mua điện thoại Samsung Galaxy A24 tại TGDĐ

Trên đây là bài viết đánh giá chi tiết về Samsung Galaxy A24: Camera 50 MP cùng chip MediaTek Helio G99.	Trên đây là bài viết đánh giá chi tiết về Samsung Galaxy A24 : Camera 50 MP cùng chip MediaTek Helio G99 .

Hy vọng bài viết mang đến những thông tin hữu ích với bạn.	Hy vọng bài viết mang đến những thông tin hữu ích với bạn .

