title: So sánh OPPO A57 và Samsung Galaxy A13: Nên chọn điện thoại nào?	title : So sánh OPPO A57 và Samsung Galaxy A13 : Nên chọn điện thoại nào ?

OPPO A57 và Samsung Galaxy A13 là hai mẫu điện thoại đang cạnh tranh trong tầm giá 4 triệu hơn.	OPPO A57 và Samsung Galaxy A13 là hai mẫu điện thoại đang cạnh tranh trong tầm giá 4 triệu hơn .

Nếu bạn đang băn khoăn không biết chọn model nào, thì hãy để FPT Shop giúp bạn nhé!	Nếu bạn đang băn khoăn không biết chọn model nào , thì hãy để FPT Shop giúp bạn nhé !

4 smartphone đẹp, “ngon” trong tầm giá dưới 5 triệu phù hợp học sinh, sinh viên	4 smartphone đẹp , “ ngon ” trong tầm giá dưới 5 triệu phù hợp học sinh , sinh viên

Top 5 smartphone giá rẻ tốt nhất năm 2022	Top 5 smartphone giá rẻ tốt nhất năm 2022

Trong bài viết này, FPT Shop sẽ so sánh chi tiết OPPO A57 và Samsung Galaxy A13 để bạn hiểu rõ từng ưu điểm từng sản phẩm.	Trong bài viết này , FPT Shop sẽ so sánh chi tiết OPPO A57 và Samsung Galaxy A13 để bạn hiểu rõ từng ưu điểm từng sản phẩm .

Từ đó, bạn có thể dễ dàng đưa ra quyết định mua phù hợp với bản thân.	Từ đó , bạn có thể dễ dàng đưa ra quyết định mua phù hợp với bản thân .

Thiết kế	Thiết kế

Samsung Galaxy A13 mang ngôn ngữ thiết kế theo dòng Galaxy A 2022 với thiết kế tối giản, điểm nhấn là màu sắc trendy.	Samsung Galaxy A13 mang ngôn ngữ thiết kế theo dòng Galaxy A 2022 với thiết kế tối giản , điểm nhấn là màu sắc trendy .

Khi chọn mua Galaxy A13, bạn sẽ có sự đa dạng về màu như cam đào, xanh dương và đen.	Khi chọn mua Galaxy A13 , bạn sẽ có sự đa dạng về màu như cam đào , xanh dương và đen .

alt: So sánh OPPO A57 và Samsung Galaxy A13: Nên chọn điện thoại nào?	alt : So sánh OPPO A57 và Samsung Galaxy A13 : Nên chọn điện thoại nào ?

des: Thiết kế Samsung Galaxy A13	des : Thiết kế Samsung Galaxy A13

Đối với OPPO A57 là thiết kế hiện đại và năng động.	Đối với OPPO A57 là thiết kế hiện đại và năng động .

Trong đó, OPPO A57 sở hữu các cạnh vuông vức, phủ nhám, cụm camera mới và màu xanh mint trẻ trung.	Trong đó , OPPO A57 sở hữu các cạnh vuông vức , phủ nhám , cụm camera mới và màu xanh mint trẻ trung .

alt: So sánh OPPO A57 và Samsung Galaxy A13: Nên chọn điện thoại nào?	alt : So sánh OPPO A57 và Samsung Galaxy A13 : Nên chọn điện thoại nào ?

des: Thiết kế OPPO A57	des : Thiết kế OPPO A57

Khi đặt thiết kế của hai sản phẩm lên “bàn cân” so sánh, bạn có thể thấy sự vượt trội của OPPO A57 với kiểu thiết kế hợp xu hướng, mang dấu ấn của các điện thoại tầm trung, cận cao cấp.	Khi đặt thiết kế của hai sản phẩm lên “ bàn cân ” so sánh , bạn có thể thấy sự vượt trội của OPPO A57 với kiểu thiết kế hợp xu hướng , mang dấu ấn của các điện thoại tầm trung , cận cao cấp .

Màn hình	Màn hình

Về phần màn hình, OPPO A57 và Galaxy A13 khá tương đồng với màn hình “giọt nước” 6.56 inch trên tấm nền LCD, cho không gian thao tác thoải mái.	Về phần màn hình , OPPO A57 và Galaxy A13 khá tương đồng với màn hình “ giọt nước ” 6.56 inch trên tấm nền LCD , cho không gian thao tác thoải mái .
{"subject": ["6&&OPPO", "7&&A57"], "object": ["9&&Galaxy", "10&&A13"], "aspect": ["3&&màn", "4&&hình"], "predicate": ["11&&khá", "12&&tương", "13&&đồng"], "label": "EQL"}

Điểm khác biệt giữa hai màn hình đó là Galaxy A13 có độ phân giải FHD+, mang tới chi tiết sắc nét hơn so với OPPO A57.	Điểm khác biệt giữa hai màn hình đó là Galaxy A13 có độ phân giải FHD + , mang tới chi tiết sắc nét hơn so với OPPO A57 .
{"subject": ["10&&Galaxy", "11&&A13"], "object": ["28&&OPPO", "29&&A57"], "aspect": ["13&&độ", "14&&phân", "15&&giải"], "predicate": ["21&&chi", "22&&tiết", "23&&sắc", "24&&nét", "25&&hơn"], "label": "COM+"}

alt: So sánh OPPO A57 và Samsung Galaxy A13: Nên chọn điện thoại nào?	alt : So sánh OPPO A57 và Samsung Galaxy A13 : Nên chọn điện thoại nào ?

des:	des :

Camera	Camera

Trong phân khúc này, Galaxy A13 là một trong ứng cử viên sáng giá về camera.	Trong phân khúc này , Galaxy A13 là một trong ứng cử viên sáng giá về camera .

Điện thoại có camera chính 50MP, camera góc rộng 5MP, camera macro 2MP và camera đo chiều sâu 2MP, mang đến nhiều góc chụp khác nhau cho người dùng.	Điện thoại có camera chính 50MP , camera góc rộng 5MP , camera macro 2MP và camera đo chiều sâu 2MP , mang đến nhiều góc chụp khác nhau cho người dùng .

Nếu bạn thích chụp nhiều góc khác nhau thì Galaxy A13 rất lý tưởng.	Nếu bạn thích chụp nhiều góc khác nhau thì Galaxy A13 rất lý tưởng .

Về OPPO A57, điện thoại có cụm camera kép 13MP + 2MP.	Về OPPO A57 , điện thoại có cụm camera kép 13MP + 2MP .

Mặc dù ít ống kính hơn nhưng khả năng tối ưu camera của OPPO cũng khá tốt nên chất lượng ảnh của A57 vẫn đáp ứng cho người dùng.	Mặc dù ít ống kính hơn nhưng khả năng tối ưu camera của OPPO cũng khá tốt nên chất lượng ảnh của A57 vẫn đáp ứng cho người dùng .

alt: So sánh OPPO A57 và Samsung Galaxy A13: Nên chọn điện thoại nào?	alt : So sánh OPPO A57 và Samsung Galaxy A13 : Nên chọn điện thoại nào ?

des:	des :

Hiệu năng	Hiệu năng

OPPO A57 sở hữu bộ vi xử lý Helio G35, đi kèm 4GB RAM, 64GB bộ nhớ trong.	OPPO A57 sở hữu bộ vi xử lý Helio G35 , đi kèm 4GB RAM , 64GB bộ nhớ trong .

Đồng thời, OPPO cũng tích hợp công nghệ mở rộng RAM, thêm 4GB, tổng RAM lên tới 8GB.	Đồng thời , OPPO cũng tích hợp công nghệ mở rộng RAM , thêm 4GB , tổng RAM lên tới 8GB .

Galaxy A13 là Exynos 850, đi kèm 4GB RAM và 128GB bộ nhớ trong.	Galaxy A13 là Exynos 850 , đi kèm 4GB RAM và 128GB bộ nhớ trong .

alt: So sánh OPPO A57 và Samsung Galaxy A13: Nên chọn điện thoại nào?	alt : So sánh OPPO A57 và Samsung Galaxy A13 : Nên chọn điện thoại nào ?

des:	des :

Hai bộ vi xử lý này cũng không có sự khác biệt nhiều về hiệu năng.	Hai bộ vi xử lý này cũng không có sự khác biệt nhiều về hiệu năng .
{"subject": ["1&&Hai", "2&&bộ", "3&&vi", "4&&xử", "5&&lý", "6&&này"], "object": ["1&&Hai", "2&&bộ", "3&&vi", "4&&xử", "5&&lý", "6&&này"], "aspect": ["15&&hiệu", "16&&năng"], "predicate": ["8&&không", "9&&có", "10&&sự", "11&&khác", "12&&biệt", "13&&nhiều"], "label": "EQL"}

Tuy nhiên, OPPO A57 có công nghệ mở rộng RAM, giúp bạn đa nhiệm tốt và dài lâu.	Tuy nhiên , OPPO A57 có công nghệ mở rộng RAM , giúp bạn đa nhiệm tốt và dài lâu .

Ở Galaxy A13, bạn sẽ có dung lượng bộ nhớ nhiều hơn.	Ở Galaxy A13 , bạn sẽ có dung lượng bộ nhớ nhiều hơn .
{"subject": ["2&&Galaxy", "3&&A13"], "object": [], "aspect": ["8&&dung", "9&&lượng", "10&&bộ", "11&&nhớ"], "predicate": ["12&&nhiều", "13&&hơn"], "label": "COM+"}

Pin và sạc nhanh	Pin và sạc nhanh

Là hai mẫu điện thoại dành cho người dùng trẻ, cả Galaxy A13 và OPPO A57 đều có viên pin 5.000mAh, giúp người dùng sử dụng thoải mái cả ngày dài.	Là hai mẫu điện thoại dành cho người dùng trẻ , cả Galaxy A13 và OPPO A57 đều có viên pin 5.000mAh , giúp người dùng sử dụng thoải mái cả ngày dài .
{"subject": ["13&&Galaxy", "14&&A13"], "object": ["16&&OPPO", "17&&A57"], "aspect": ["20&&viên", "21&&pin", "22&&5.000mAh"], "predicate": ["18&&đều", "19&&có"], "label": "EQL"}

Về sạc nhanh, OPPO A57 vượt trội hơn hẳn khi đây là mẫu điện thoại có sạc nhanh nhất phân khúc tới 33W, tiết kiệm thời gian tối ưu, rất tiện lợi.	Về sạc nhanh , OPPO A57 vượt trội hơn hẳn khi đây là mẫu điện thoại có sạc nhanh nhất phân khúc tới 33W , tiết kiệm thời gian tối ưu , rất tiện lợi .
{"subject": ["5&&OPPO", "6&&A57"], "object": [], "aspect": ["2&&sạc", "3&&nhanh"], "predicate": ["7&&vượt", "8&&trội", "9&&hơn", "10&&hẳn"], "label": "COM+"}

Đối với Galaxy A13 là sạc 15W.	Đối với Galaxy A13 là sạc 15W .

alt: So sánh OPPO A57 và Samsung Galaxy A13: Nên chọn điện thoại nào?	alt : So sánh OPPO A57 và Samsung Galaxy A13 : Nên chọn điện thoại nào ?

des:	des :

Kết lại	Kết lại

Nhìn chung, cả hai sản phẩm đều có ưu điểm về pin trâu, hiệu năng ổn định trong tầm giá.	Nhìn chung , cả hai sản phẩm đều có ưu điểm về pin trâu , hiệu năng ổn định trong tầm giá .

Tuy nhiên, nếu bạn thích camera tốt, màn hình, bộ nhớ nhiều hơn thì có thể chọn Galaxy A13.	Tuy nhiên , nếu bạn thích camera tốt , màn hình , bộ nhớ nhiều hơn thì có thể chọn Galaxy A13 .
{"subject": [], "object": ["21&&Galaxy", "22&&A13"], "aspect": ["13&&bộ", "14&&nhớ"], "predicate": ["15&&nhiều", "16&&hơn"], "label": "COM+"}

Đối với người dùng muốn chiếc điện thoại có thiết kế hợp xu hướng, sạc nhanh 33W, mở rộng RAM, thì OPPO A57 sẽ phù hợp.	Đối với người dùng muốn chiếc điện thoại có thiết kế hợp xu hướng , sạc nhanh 33W , mở rộng RAM , thì OPPO A57 sẽ phù hợp .

Đồng thời, OPPO A57 cũng có giá bán phải chăng hơn 200.000 đồng.	Đồng thời , OPPO A57 cũng có giá bán phải chăng hơn 200.000 đồng .

Bạn sẽ chọn Galaxy A13 hay OPPO A57, chia sẻ với mình bằng cách bình luận phía dưới nhé!	Bạn sẽ chọn Galaxy A13 hay OPPO A57 , chia sẻ với mình bằng cách bình luận phía dưới nhé !

