title: Đánh giá Samsung Galaxy M51: Pin rất khủng, màn hình đẹp, giá rẻ	title : Đánh giá Samsung Galaxy M51 : Pin rất khủng , màn hình đẹp , giá rẻ

Đầu tháng 9 vừa qua, Samsung lại ra mắt thêm một sản phẩm tuyệt vời ở phân khúc tầm trung.	Đầu tháng 9 vừa qua , Samsung lại ra mắt thêm một sản phẩm tuyệt vời ở phân khúc tầm trung .

Đó chính là chiếc Samsung Galaxy M51.	Đó chính là chiếc Samsung Galaxy M51 .

Mình phải nói là Samsung thực sự “sởi lởi” khi trang bị cho chiếc điện thoại mới này rất nhiều thứ.	Mình phải nói là Samsung thực sự “ sởi lởi ” khi trang bị cho chiếc điện thoại mới này rất nhiều thứ .

Đó là một viên pin khủng tới 7000 mAh, một màn hình Super AMOLED 6.7 inch nằm ở tầm trung.	Đó là một viên pin khủng tới 7000 mAh , một màn hình Super AMOLED 6.7 inch nằm ở tầm trung .

Vậy ngoài ra chiếc điện thoại này còn gì nổi bật nữa không?	Vậy ngoài ra chiếc điện thoại này còn gì nổi bật nữa không ?

Nó có thực sự nổi bật trong phân khúc không?	Nó có thực sự nổi bật trong phân khúc không ?

Cùng tìm hiểu chi tiết hơn về chiếc điện thoại này qua bài đánh giá dưới đây của mình.	Cùng tìm hiểu chi tiết hơn về chiếc điện thoại này qua bài đánh giá dưới đây của mình .

Thông số kỹ thuật	Thông số kỹ thuật

Đánh giá chi tiết điện thoại Samsung Galaxy M51	Đánh giá chi tiết điện thoại Samsung Galaxy M51

Thiết kế	Thiết kế

Nói về thiết kế, mình phải nói đó là một bước đột phá mạnh mẽ của Samsung.	Nói về thiết kế , mình phải nói đó là một bước đột phá mạnh mẽ của Samsung .

Từ trước đến nay, chúng ta đã thấy những chiếc điện thoại pin 5000 mAh đã gặp rắc rối thiết kế vì có một thân máy dày.	Từ trước đến nay , chúng ta đã thấy những chiếc điện thoại pin 5000 mAh đã gặp rắc rối thiết kế vì có một thân máy dày .

Đó là một điều khó chịu khi chúng ta dùng smartphone.	Đó là một điều khó chịu khi chúng ta dùng smartphone .

alt: Samsung Galaxy M51	alt : Samsung Galaxy M51

des: Samsung Galaxy M51	des : Samsung Galaxy M51

Nhưng đối với Samsung Galaxy M51 thì vấn đề đó đã được giải quyết, mặc dù nó mang trong mình viên pin 7000 mAh nhưng độ dày của nó cũng chỉ tương đương như những chiếc S20 mà thôi.	Nhưng đối với Samsung Galaxy M51 thì vấn đề đó đã được giải quyết , mặc dù nó mang trong mình viên pin 7000 mAh nhưng độ dày của nó cũng chỉ tương đương như những chiếc S20 mà thôi .
{"subject": ["4&&Samsung", "5&&Galaxy", "6&&M51"], "object": ["36&&những", "37&&chiếc", "38&&S20"], "aspect": ["27&&độ", "28&&dày"], "predicate": ["33&&tương", "34&&đương"], "label": "EQL"}

Tuy nhiên khi nhắc tới độ nặng, nó chỉ được hoàn thiện bằng nhựa giả kính bên ngoài, nó vẫn có sức nặng 213 g.	Tuy nhiên khi nhắc tới độ nặng , nó chỉ được hoàn thiện bằng nhựa giả kính bên ngoài , nó vẫn có sức nặng 213 g .

Như vậy với độ dày 9.5 mm cùng cân nặng này mà có viên pin 7.000 mAh là chấp nhận được ở một chiếc smartphone 2020.	Như vậy với độ dày 9.5 mm cùng cân nặng này mà có viên pin 7.000 mAh là chấp nhận được ở một chiếc smartphone 2020 .

Ngoài độ dày và trọng lượng mang tính đột phá thì hầu hết thiết kế của chiếc M51 này là một điển hình của Samsung trong năm 2020.	Ngoài độ dày và trọng lượng mang tính đột phá thì hầu hết thiết kế của chiếc M51 này là một điển hình của Samsung trong năm 2020 .

Đó là một mặt lưng cong, các cạnh phẳng và các góc bo tròn.	Đó là một mặt lưng cong , các cạnh phẳng và các góc bo tròn .

Lựa chọn màu sắc có vẻ hơi đơn điệu khi bạn chỉ có 2 lựa chọn màu là Celestial Black, Electric Blue.	Lựa chọn màu sắc có vẻ hơi đơn điệu khi bạn chỉ có 2 lựa chọn màu là Celestial Black , Electric Blue .

Mặt trước	Mặt trước

Mặt trước là một màn hình Super AMOLED Plus lớn tới 6.7 inch.	Mặt trước là một màn hình Super AMOLED Plus lớn tới 6.7 inch .

Màn hình thực sự lớn kết hợp với các cạnh cực mỏng cho trải nghiệm màn hình là rất tuyệt vời.	Màn hình thực sự lớn kết hợp với các cạnh cực mỏng cho trải nghiệm màn hình là rất tuyệt vời .

alt: Samsung Galaxy M51	alt : Samsung Galaxy M51

des: Samsung Galaxy M51	des : Samsung Galaxy M51

Màn hình đục lỗ không khống chế ở góc màn hình mà lại là chính giữa có vẻ hơi lạ so với những màn hình khác.	Màn hình đục lỗ không khống chế ở góc màn hình mà lại là chính giữa có vẻ hơi lạ so với những màn hình khác .
{"subject": ["1&&Màn", "2&&hình", "3&&đục", "4&&lỗ", "5&&không", "6&&khống", "7&&chế", "8&&ở", "9&&góc", "10&&màn", "11&&hình", "12&&mà", "13&&lại", "14&&là", "15&&chính", "16&&giữa"], "object": ["23&&những", "24&&màn", "25&&hình", "26&&khác"], "aspect": [], "predicate": ["19&&hơi", "20&&lạ"], "label": "DIF"}

Tuy rằng đục lỗ không nhỏ như những chiếc Flagship nhưng nó cũng được không chế khá tốt để không ảnh hưởng nhiều tới trải nghiệm màn hình.	Tuy rằng đục lỗ không nhỏ như những chiếc Flagship nhưng nó cũng được không chế khá tốt để không ảnh hưởng nhiều tới trải nghiệm màn hình .
{"subject": ["12&&nó"], "object": ["8&&những", "9&&chiếc", "10&&Flagship"], "aspect": ["3&&đục", "4&&lỗ"], "predicate": ["5&&không", "6&&nhỏ", "7&&như"], "label": "COM-"}

Cạnh tiếp xúc giữa màn hình và khung máy chình là dải loa thoại khá ngắn và dễ dàng nhìn thấy.	Cạnh tiếp xúc giữa màn hình và khung máy chình là dải loa thoại khá ngắn và dễ dàng nhìn thấy .

Mặt sau	Mặt sau

Mặt sau hoàn thiện bằng nhựa bóng như mình đã nói.	Mặt sau hoàn thiện bằng nhựa bóng như mình đã nói .

Nhưng điều này thực sự dễ hiểu khi nó phải hi sinh để có một viên pin lớn cùng trọng lượng chấp nhận được.	Nhưng điều này thực sự dễ hiểu khi nó phải hi sinh để có một viên pin lớn cùng trọng lượng chấp nhận được .

Nếu nó là mặt kính hoặc mặt nhôm thì trọng lượng sẽ rất lớn và bạn sẽ có cảm giác thực sự là cầm một “cục gạch” trong tay.	Nếu nó là mặt kính hoặc mặt nhôm thì trọng lượng sẽ rất lớn và bạn sẽ có cảm giác thực sự là cầm một “ cục gạch ” trong tay .

alt: Samsung Galaxy M51	alt : Samsung Galaxy M51

des: Samsung Galaxy M51	des : Samsung Galaxy M51

Nổi bật ở mặt sau này là một cụm 4 camera nằm trong khung hình chữ nhật trên góc trái.	Nổi bật ở mặt sau này là một cụm 4 camera nằm trong khung hình chữ nhật trên góc trái .

Trang bị ống kính chính lớn nhất mới 64MP nên cụm camera này không có nhô ra quá nhiều như chiếc  Samsung Galaxy S20  năm nay.	Trang bị ống kính chính lớn nhất mới 64MP nên cụm camera này không có nhô ra quá nhiều như chiếc Samsung Galaxy S20 năm nay .
{"subject": ["11&&cụm", "12&&camera", "13&&này"], "object": ["22&&Samsung", "23&&Galaxy", "24&&S20"], "aspect": [], "predicate": ["14&&không", "15&&có", "16&&nhô", "17&&ra", "18&&quá", "19&&nhiều", "20&&như"], "label": "COM+"}

Tất nhiên nó vẫn có độ chênh nhất định khi bạn đặt trên mặt bàn.	Tất nhiên nó vẫn có độ chênh nhất định khi bạn đặt trên mặt bàn .

Hoàn thiện nhựa bóng thực sự vẫn dễ bị xước và là trung tâm thu hút mồ hôi cùng với vân tay.	Hoàn thiện nhựa bóng thực sự vẫn dễ bị xước và là trung tâm thu hút mồ hôi cùng với vân tay .

Với một lớp vỏ này thì tốt nhất bạn nên dùng ốp lưng để có thể bảo vệ tốt nhất cho điện thoại nhé.	Với một lớp vỏ này thì tốt nhất bạn nên dùng ốp lưng để có thể bảo vệ tốt nhất cho điện thoại nhé .

Các cạnh còn lại	Các cạnh còn lại

Mặt sau hoàn thiện bằng nhựa thì khung máy cũng là nhựa và sơn bóng như vậy.	Mặt sau hoàn thiện bằng nhựa thì khung máy cũng là nhựa và sơn bóng như vậy .

Như thường lệ các cổng kết nối cùng nút bấm đều được tích hợp trên khung máy này.	Như thường lệ các cổng kết nối cùng nút bấm đều được tích hợp trên khung máy này .
{"subject": ["4&&các", "5&&cổng", "6&&kết", "7&&nối", "8&&cùng", "9&&nút", "10&&bấm"], "object": [], "aspect": [], "predicate": ["11&&đều", "12&&được", "13&&tích", "14&&hợp", "15&&trên", "16&&khung", "17&&máy", "18&&này"], "label": "EQL"}

alt: Samsung Galaxy M51	alt : Samsung Galaxy M51

des: Samsung Galaxy M51	des : Samsung Galaxy M51

Cạnh bên trái Galaxy M51	Cạnh bên trái Galaxy M51

Cạnh bên trái không có gì ngoài khay sim.	Cạnh bên trái không có gì ngoài khay sim .

Bạn sẽ thấy khay sim có 2 vị trí cho thẻ sim và vị trí thẻ nhớ độc lập.	Bạn sẽ thấy khay sim có 2 vị trí cho thẻ sim và vị trí thẻ nhớ độc lập .

Vậy nên bạn không cần phải phân vân giữa mở rộng bộ nhớ và dùng sim kép.	Vậy nên bạn không cần phải phân vân giữa mở rộng bộ nhớ và dùng sim kép .

alt: Samsung Galaxy M51	alt : Samsung Galaxy M51

des: Samsung Galaxy M51	des : Samsung Galaxy M51

Cạnh bên phải Galaxy M51	Cạnh bên phải Galaxy M51

Cạnh bên phải chứa nút nguồn cùng với phím tăng giảm âm lượng, chúng hơi dịch lên phía trên một chút so với các mẫu điện thoại khác.	Cạnh bên phải chứa nút nguồn cùng với phím tăng giảm âm lượng , chúng hơi dịch lên phía trên một chút so với các mẫu điện thoại khác .
{"subject": [], "object": ["25&&các", "26&&mẫu", "27&&điện", "28&&thoại", "29&&khác"], "aspect": ["5&&nút", "6&&nguồn"], "predicate": ["16&&hơi", "17&&dịch", "18&&lên", "19&&phía", "20&&trên", "21&&một", "22&&chút"], "label": "DIF"}
{"subject": [], "object": ["25&&các", "26&&mẫu", "27&&điện", "28&&thoại", "29&&khác"], "aspect": ["9&&phím", "10&&tăng", "11&&giảm", "12&&âm", "13&&lượng"], "predicate": ["16&&hơi", "17&&dịch", "18&&lên", "19&&phía", "20&&trên", "21&&một", "22&&chút"], "label": "DIF"}

Hơn nữa cảm biến vân tay được tích hợp trong phím nguồn vì thế phím nguồn được vát bằng và hơi lõm so với khung máy.	Hơn nữa cảm biến vân tay được tích hợp trong phím nguồn vì thế phím nguồn được vát bằng và hơi lõm so với khung máy .

alt: Samsung Galaxy M51	alt : Samsung Galaxy M51

des: Samsung Galaxy M51	des : Samsung Galaxy M51

Cạnh trên Galaxy M51	Cạnh trên Galaxy M51

Cạnh phía trên vẫn không có gì ngoài một chiếc micro phụ ở đây.	Cạnh phía trên vẫn không có gì ngoài một chiếc micro phụ ở đây .

alt: Samsung Galaxy M51	alt : Samsung Galaxy M51

des: Samsung Galaxy M51	des : Samsung Galaxy M51

Cạnh dưới Samsung Galaxy M51	Cạnh dưới Samsung Galaxy M51

Cạnh dưới rất đầy đủ và sự có mặt của jack cắm tai nghe 3.5 mm là điều đáng hoan nghênh khi mà hầu hết điện thoại cùng tầm giá đều cắt bỏ điều này.	Cạnh dưới rất đầy đủ và sự có mặt của jack cắm tai nghe 3.5 mm là điều đáng hoan nghênh khi mà hầu hết điện thoại cùng tầm giá đều cắt bỏ điều này .

Ngoài jack cắm tai nghe chúng ta còn có một khe cắm sạc USB type C, micro chính cùng với loa ngoài ở đây.	Ngoài jack cắm tai nghe chúng ta còn có một khe cắm sạc USB type C , micro chính cùng với loa ngoài ở đây .

Màn hình	Màn hình

Samsung Galaxy M51 được trang bị màn hình Super AMOLED 6.7 inch với độ phân giải Full HD+ (2400 x 1080).	Samsung Galaxy M51 được trang bị màn hình Super AMOLED 6.7 inch với độ phân giải Full HD + ( 2400 x 1080 ) .

Tuy nhiên màn hình này chỉ được bảo vệ bởi một tấm cường lực Corning gorilla glass 3 mà thôi.	Tuy nhiên màn hình này chỉ được bảo vệ bởi một tấm cường lực Corning gorilla glass 3 mà thôi .

Trong khi điện thoại hiện nay đã có một miếng tấm kính mới thế hệ thứ 7 mà Corning gọi là Victus.	Trong khi điện thoại hiện nay đã có một miếng tấm kính mới thế hệ thứ 7 mà Corning gọi là Victus .

alt: Samsung Galaxy M51	alt : Samsung Galaxy M51

des: Samsung Galaxy M51	des : Samsung Galaxy M51

Còn một điều đáng tiếc khác chính là tốc độ làm mới của màn hình Galaxy M51 chỉ ở mức mặc định 60Hz mà thôi.	Còn một điều đáng tiếc khác chính là tốc độ làm mới của màn hình Galaxy M51 chỉ ở mức mặc định 60Hz mà thôi .

Điều này vẫn để mình cảm thấy tiếc nuối vì Samsung thường vẫn nhỉnh hơn các thương hiệu khác ở chất lượng màn hình nhưng giờ đây nó vẫn thua kém ở tốc độ làm mới.	Điều này vẫn để mình cảm thấy tiếc nuối vì Samsung thường vẫn nhỉnh hơn các thương hiệu khác ở chất lượng màn hình nhưng giờ đây nó vẫn thua kém ở tốc độ làm mới .
{"subject": ["11&&Samsung"], "object": ["16&&các", "17&&thương", "18&&hiệu", "19&&khác"], "aspect": ["21&&chất", "22&&lượng", "23&&màn", "24&&hình"], "predicate": ["14&&nhỉnh", "15&&hơn"], "label": "COM+"}
{"subject": ["28&&nó"], "object": [], "aspect": ["33&&tốc", "34&&độ", "35&&làm", "36&&mới"], "predicate": ["30&&thua", "31&&kém"], "label": "COM-"}

So sánh một chút với chiếc Realme 6 hoặc Realme 7 có tốc độ làm mới 90Hz. Hay một sản phẩm của Xiaomi là POCO X2 có tốc độ 120 Hz. Hơn nữa mức giá của chúng là tương đương với chiếc M51 này.	So sánh một chút với chiếc Realme 6 hoặc Realme 7 có tốc độ làm mới 90Hz . Hay một sản phẩm của Xiaomi là POCO X2 có tốc độ 120 Hz . Hơn nữa mức giá của chúng là tương đương với chiếc M51 này .
{"subject": ["39&&chúng"], "object": ["44&&chiếc", "45&&M51", "46&&này"], "aspect": ["36&&mức", "37&&giá"], "predicate": ["41&&tương", "42&&đương"], "label": "EQL"}

Nếu bạn trải nghiệm thực tế bạn sẽ thấy mặc dù chipset của nó là Snapdragon 730G nhưng độ mượt khi chơi game không thể so sánh với màn hình 90Hz cùng chipset.	Nếu bạn trải nghiệm thực tế bạn sẽ thấy mặc dù chipset của nó là Snapdragon 730G nhưng độ mượt khi chơi game không thể so sánh với màn hình 90Hz cùng chipset .
{"subject": ["14&&nó"], "object": ["29&&màn", "30&&hình", "31&&90Hz", "32&&cùng", "33&&chipset"], "aspect": ["19&&độ", "20&&mượt", "21&&khi", "22&&chơi", "23&&game"], "predicate": ["24&&không", "25&&thể", "26&&so", "27&&sánh", "28&&với"], "label": "COM-"}

Tuy nói về những điểm yếu như vậy nhưng khả năng hiển thị của nó vẫn rất tốt với tấm nền “Super AMOLED plus” nhé.	Tuy nói về những điểm yếu như vậy nhưng khả năng hiển thị của nó vẫn rất tốt với tấm nền “ Super AMOLED plus ” nhé .

Nó vẫn là Diamond PenTil nhưng là một bảng điều khiển mỏng hơn, các góc nhìn tuyệt vời hơn.	Nó vẫn là Diamond PenTil nhưng là một bảng điều khiển mỏng hơn , các góc nhìn tuyệt vời hơn .

Tất nhiên độ tương phản màn hình AMOLED gần như vô cực rồi.	Tất nhiên độ tương phản màn hình AMOLED gần như vô cực rồi .

Độ tái hiện màu sắc tự nhiên được hiệu chỉnh theo sRGB và DCI-P3 nhờ có quản lý màu tự động.	Độ tái hiện màu sắc tự nhiên được hiệu chỉnh theo sRGB và DCI-P3 nhờ có quản lý màu tự động .

Phần mềm	Phần mềm

Samsung Galaxy M51 chạy hệ điều hành Android 10 với giao diện người dùng One UI 2.1 Core.	Samsung Galaxy M51 chạy hệ điều hành Android 10 với giao diện người dùng One UI 2.1 Core .

Với phiên bản phần mềm này bạn sẽ có nhiều tính năng mới như ghi màn hình tích hợp và chế độ máy ảnh Pro đầy đủ.	Với phiên bản phần mềm này bạn sẽ có nhiều tính năng mới như ghi màn hình tích hợp và chế độ máy ảnh Pro đầy đủ .

Đổi lại bạn sẽ không có Samsung Pay và các tính năng như bảo mật thư mục.	Đổi lại bạn sẽ không có Samsung Pay và các tính năng như bảo mật thư mục .

Ngay cả khi phần mềm được cập nhật thì những tính năng này cũng không thể có được vì điện thoại dòng M không có chứng nhận Knox.	Ngay cả khi phần mềm được cập nhật thì những tính năng này cũng không thể có được vì điện thoại dòng M không có chứng nhận Knox .

Vì thế sẽ không an toàn lắm cho những ứng dụng của bạn, tất nhiên bảo mật hệ thống vẫn rất tốt chỉ cần bạn cẩn thận một chút là được.	Vì thế sẽ không an toàn lắm cho những ứng dụng của bạn , tất nhiên bảo mật hệ thống vẫn rất tốt chỉ cần bạn cẩn thận một chút là được .

alt: Đánh giá điện thoại Samsung Galaxy M51 11	alt : Đánh giá điện thoại Samsung Galaxy M51 11

des: Đánh giá điện thoại Samsung Galaxy M51 11	des : Đánh giá điện thoại Samsung Galaxy M51 11

One UI 2.1 Core mới của Samsung bây giờ đã được hoàn thiện hơn nhiều và cung cấp cho bạn những trải nghiệm mượt mà và không gặp bất kỳ trục trặc nào.	One UI 2.1 Core mới của Samsung bây giờ đã được hoàn thiện hơn nhiều và cung cấp cho bạn những trải nghiệm mượt mà và không gặp bất kỳ trục trặc nào .

Chủ đề tối toàn hệ thống và lọc ánh sáng xanh rất được yêu thích vì sử dụng điện thoại trong không gian tối sẽ dễ dàng hơn khi không bị chói mắt.	Chủ đề tối toàn hệ thống và lọc ánh sáng xanh rất được yêu thích vì sử dụng điện thoại trong không gian tối sẽ dễ dàng hơn khi không bị chói mắt .

Có một tính năng cực hay ở phiên bản One UI mới này nữa chính là thông báo bật lên thông minh.	Có một tính năng cực hay ở phiên bản One UI mới này nữa chính là thông báo bật lên thông minh .

Bất cứ khi nào bạn nhận được thông báo từ ứng dụng thì nó sẽ xuất hiện dưới dạng bong bóng như của messenger.	Bất cứ khi nào bạn nhận được thông báo từ ứng dụng thì nó sẽ xuất hiện dưới dạng bong bóng như của messenger .

Bạn có thể nhấp vào đó và nó sẽ hiển thị một cửa số nổi y chang messenger.	Bạn có thể nhấp vào đó và nó sẽ hiển thị một cửa số nổi y chang messenger .

Tuy nhiên kích thước và độ mờ của cửa sổ nổi này bạn có thể điều chỉnh được.	Tuy nhiên kích thước và độ mờ của cửa sổ nổi này bạn có thể điều chỉnh được .

Một điểm hay nữa là bạn chỉ cần vuốt từ trên xuống dưới ở cảm biến vân tay, bảng thông báo sẽ tự đọng kéo xuống dù bạn đang ở chế độ nào.	Một điểm hay nữa là bạn chỉ cần vuốt từ trên xuống dưới ở cảm biến vân tay , bảng thông báo sẽ tự đọng kéo xuống dù bạn đang ở chế độ nào .

Hiệu năng	Hiệu năng

Samsung Galaxy M51 trang bị bộ xử lý Snapdragon 730G 8nm.	Samsung Galaxy M51 trang bị bộ xử lý Snapdragon 730G 8nm .

Đó là chipset lõi tám (2×2,2 GHz Kryo 470 Gold và 6×1,8 GHz Kryo 470 Silver) cùng với GPU Adreno 618.	Đó là chipset lõi tám ( 2 × 2,2 GHz Kryo 470 Gold và 6 × 1,8 GHz Kryo 470 Silver ) cùng với GPU Adreno 618 .

Đây là điện thoại Galaxy M-series thứ 4 trang bị bộ xử lý của Qualcomm.	Đây là điện thoại Galaxy M-series thứ 4 trang bị bộ xử lý của Qualcomm .

Trước đó chúng ta cũng bắt gặp ở  Galaxy M41 , Galaxy M01 và Galaxy M11 nhưng Snapdragon 730G cho phép M51 trở thành điện thoại mạnh mẽ nhất trong dòng M.	Trước đó chúng ta cũng bắt gặp ở Galaxy M41 , Galaxy M01 và Galaxy M11 nhưng Snapdragon 730G cho phép M51 trở thành điện thoại mạnh mẽ nhất trong dòng M .
{"subject": ["22&&M51"], "object": [], "aspect": [], "predicate": ["27&&mạnh", "28&&mẽ", "29&&nhất", "30&&trong", "31&&dòng", "32&&M"], "label": "SUP+"}

alt: Đánh giá điện thoại Samsung Galaxy M51	alt : Đánh giá điện thoại Samsung Galaxy M51

des: Đánh giá điện thoại Samsung Galaxy M51	des : Đánh giá điện thoại Samsung Galaxy M51

Nhìn qua một chút khi chạy các bài kiểm tra hiệu năng, Galaxy M51 hoạt động kém hơn ở hầu hết các mức điểm chuẩn phổ biến.	Nhìn qua một chút khi chạy các bài kiểm tra hiệu năng , Galaxy M51 hoạt động kém hơn ở hầu hết các mức điểm chuẩn phổ biến .
{"subject": ["14&&Galaxy", "15&&M51"], "object": ["23&&các", "24&&mức", "25&&điểm", "26&&chuẩn", "27&&phổ", "28&&biến"], "aspect": ["11&&hiệu", "12&&năng"], "predicate": ["18&&kém", "19&&hơn"], "label": "COM-"}

Điểm số Geekbench 5 của nó thấp hơn so với các thiết bị chạy Snapdragon 730G khác.	Điểm số Geekbench 5 của nó thấp hơn so với các thiết bị chạy Snapdragon 730G khác .
{"subject": ["6&&nó"], "object": ["11&&các", "12&&thiết", "13&&bị", "14&&chạy", "15&&Snapdragon", "16&&730G", "17&&khác"], "aspect": ["1&&Điểm", "2&&số", "3&&Geekbench", "4&&5"], "predicate": ["7&&thấp", "8&&hơn"], "label": "COM-"}

Có thể mình đã mong chờ quá nhiều ở điểm số PCMark, nhưng thực sự M51 vẫn có điểm số không tốt lắm!	Có thể mình đã mong chờ quá nhiều ở điểm số PCMark , nhưng thực sự M51 vẫn có điểm số không tốt lắm !

GPU Adreno 618 của Snapdragon 730G là một bước tiến so với Adreno 612 của Snapdragon 675.	GPU Adreno 618 của Snapdragon 730G là một bước tiến so với Adreno 612 của Snapdragon 675 .
{"subject": ["1&&GPU", "2&&Adreno", "3&&618", "4&&của", "5&&Snapdragon", "6&&730G"], "object": ["13&&Adreno", "14&&612", "15&&của", "16&&Snapdragon", "17&&675"], "aspect": [], "predicate": ["8&&một", "9&&bước", "10&&tiến", "11&&so", "12&&với"], "label": "COM+"}

Tuy nhiên, nó thua kém GPU Adreno 620 của Snapdragon 765G một chút.	Tuy nhiên , nó thua kém GPU Adreno 620 của Snapdragon 765G một chút .
{"subject": ["4&&nó"], "object": ["7&&GPU", "8&&Adreno", "9&&620", "10&&của", "11&&Snapdragon", "12&&765G"], "aspect": [], "predicate": ["5&&thua", "6&&kém"], "label": "COM-"}

Galaxy M51 một lần nữa cho điểm số và tốc độ khung hình thấp hơn so với các thiết bị chạy Snapdragon 730G khác.	Galaxy M51 một lần nữa cho điểm số và tốc độ khung hình thấp hơn so với các thiết bị chạy Snapdragon 730G khác .
{"subject": ["1&&Galaxy", "2&&M51"], "object": ["18&&các", "19&&thiết", "20&&bị", "21&&chạy", "22&&Snapdragon", "23&&730G", "24&&khác"], "aspect": ["7&&điểm", "8&&số"], "predicate": ["14&&thấp", "15&&hơn"], "label": "COM-"}
{"subject": ["1&&Galaxy", "2&&M51"], "object": ["18&&các", "19&&thiết", "20&&bị", "21&&chạy", "22&&Snapdragon", "23&&730G", "24&&khác"], "aspect": ["10&&tốc", "11&&độ", "12&&khung", "13&&hình"], "predicate": ["14&&thấp", "15&&hơn"], "label": "COM-"}

Khả năng chơi game	Khả năng chơi game

Trước khi nói về khả năng chơi game, mình thấy tốc độ làm mới màn hình của chiếc M51 này chỉ ở mức 60Hz. Ban đầu cảm thấy quá thấp so với các màn hình có tốc độ làm mới 90 Hz hay 120 Hz của Realme hoặc Xiaomi.	Trước khi nói về khả năng chơi game , mình thấy tốc độ làm mới màn hình của chiếc M51 này chỉ ở mức 60Hz . Ban đầu cảm thấy quá thấp so với các màn hình có tốc độ làm mới 90 Hz hay 120 Hz của Realme hoặc Xiaomi .
{"subject": ["16&&màn", "17&&hình", "18&&của", "19&&chiếc", "20&&M51"], "object": ["35&&các", "36&&màn", "37&&hình", "38&&có", "39&&tốc", "40&&độ", "41&&làm", "42&&mới", "43&&90", "44&&Hz", "45&&hay", "46&&120", "47&&Hz", "48&&của", "49&&Realme", "50&&hoặc", "51&&Xiaomi"], "aspect": ["12&&tốc", "13&&độ", "14&&làm", "15&&mới"], "predicate": ["31&&quá", "32&&thấp", "33&&so", "34&&với"], "label": "COM-"}

Tuy nhiên tốc độ 60Hz được duy trì rất ổn định và không bị tụt khung hình khi chơi game.	Tuy nhiên tốc độ 60Hz được duy trì rất ổn định và không bị tụt khung hình khi chơi game .

Tất nhiên nó không thể lên cao hơn 60 được.	Tất nhiên nó không thể lên cao hơn 60 được .

Nói về khả năng chơi game thì con chip chuyên game Snapdragon 730G này là thoải mái cho bạn chơi rồi.	Nói về khả năng chơi game thì con chip chuyên game Snapdragon 730G này là thoải mái cho bạn chơi rồi .

Dù là những game đòi hỏi đồ họa cao cũng “cân” tốt, tất nhiên là mình đang nói tới max setting nha.	Dù là những game đòi hỏi đồ họa cao cũng “ cân ” tốt , tất nhiên là mình đang nói tới max setting nha .

alt: Đánh giá điện thoại Samsung Galaxy M51	alt : Đánh giá điện thoại Samsung Galaxy M51

des: Đánh giá điện thoại Samsung Galaxy M51	des : Đánh giá điện thoại Samsung Galaxy M51

Galaxy M51 chơi PUBG	Galaxy M51 chơi PUBG

Khi chơi PUBG mobile, mặc dù để max đồ họa nhưng nó vẫn cực kỳ mượt mà.	Khi chơi PUBG mobile , mặc dù để max đồ họa nhưng nó vẫn cực kỳ mượt mà .

Như mình nói màn hình rất ổn định ở 60Hz cùng với chip ngon thì việc ổn định hình ảnh ở 60 fps là quá dễ với sản phẩm này.	Như mình nói màn hình rất ổn định ở 60Hz cùng với chip ngon thì việc ổn định hình ảnh ở 60 fps là quá dễ với sản phẩm này .

Kể cả lúc bạn bung dù hay bắn “hội đồng” thì nó cũng rất mượt mà.	Kể cả lúc bạn bung dù hay bắn “ hội đồng ” thì nó cũng rất mượt mà .

Di chuyển dễ dàng, hiển thị bụi cỏ rung động và âm thanh các kiểu rất thật.	Di chuyển dễ dàng , hiển thị bụi cỏ rung động và âm thanh các kiểu rất thật .

PUBG là game đòi hỏi đồ họa rất cao mà còn chơi được như thế thì chơi Liên Quân cũng chẳng có gì trở ngại nó được cả.	PUBG là game đòi hỏi đồ họa rất cao mà còn chơi được như thế thì chơi Liên Quân cũng chẳng có gì trở ngại nó được cả .

Với cài đặt max đồ họa bạn sẽ có cảm nhận tuyệt vời hơn.	Với cài đặt max đồ họa bạn sẽ có cảm nhận tuyệt vời hơn .

Bụi cỏ lay động, farm quái cũng thấy thích.	Bụi cỏ lay động , farm quái cũng thấy thích .

Nhất là khi combat tổng, bạn sẽ thoải mái thể hiện kỹ năng của mình mà không bị cản trở bởi giật lag các kiểu.	Nhất là khi combat tổng , bạn sẽ thoải mái thể hiện kỹ năng của mình mà không bị cản trở bởi giật lag các kiểu .

Camera	Camera

Samsung Galaxy M51 được trang bị bộ tứ camera phía sau bao gồm:	Samsung Galaxy M51 được trang bị bộ tứ camera phía sau bao gồm :

Cùng với đó là một camera selfie được trang bị cảm biến lên tới 32 MP f / 2.0, 26mm, 1 / 2.8 “, 0.8µm.	Cùng với đó là một camera selfie được trang bị cảm biến lên tới 32 MP f / 2.0 , 26mm , 1 / 2.8 “ , 0.8µm .

alt: Đánh giá điện thoại Samsung Galaxy M51	alt : Đánh giá điện thoại Samsung Galaxy M51

des: Đánh giá điện thoại Samsung Galaxy M51	des : Đánh giá điện thoại Samsung Galaxy M51

Đối với phần mềm chụp ảnh, Samsung đã tích hợp tính năng “chụp một lần” để chụp ảnh và quay video với tất cả các ống kính cùng lúc.	Đối với phần mềm chụp ảnh , Samsung đã tích hợp tính năng “ chụp một lần ” để chụp ảnh và quay video với tất cả các ống kính cùng lúc .

Điều này cho bạn những bức ảnh và khoảnh khắc đẹp nhất cho mỗi khung hình.	Điều này cho bạn những bức ảnh và khoảnh khắc đẹp nhất cho mỗi khung hình .

Tính năng này mới chỉ tìm thấy trên các sản phẩm cao cấp của Samsung như S20 và Note 20 series năm nay.	Tính năng này mới chỉ tìm thấy trên các sản phẩm cao cấp của Samsung như S20 và Note 20 series năm nay .

Tất nhiên sau khi chụp tất cả, bạn có thể lựa chọn cái nào đẹp thì để lại và không đẹp lắm thì không lưu.	Tất nhiên sau khi chụp tất cả , bạn có thể lựa chọn cái nào đẹp thì để lại và không đẹp lắm thì không lưu .

Tính năng này cũng được tích hợp ở camera trước.	Tính năng này cũng được tích hợp ở camera trước .

Camera chính	Camera chính

Trong điều kiện đủ sáng, camera chính tạo ra hình ảnh tuyệt vời.	Trong điều kiện đủ sáng , camera chính tạo ra hình ảnh tuyệt vời .

Độ sặc nét cao nhưng không quá mức, dải động rộng, màu sắc bão hòa nhẹ.	Độ sặc nét cao nhưng không quá mức , dải động rộng , màu sắc bão hòa nhẹ .

Nhìn chung là khả năng xử lý hình ảnh trong điều kiện đủ sáng khá tốt.	Nhìn chung là khả năng xử lý hình ảnh trong điều kiện đủ sáng khá tốt .

alt: Đánh giá điện thoại Samsung Galaxy M51	alt : Đánh giá điện thoại Samsung Galaxy M51

des: Đánh giá điện thoại Samsung Galaxy M51	des : Đánh giá điện thoại Samsung Galaxy M51

Ảnh chụp thường đủ sáng từ camera chính	Ảnh chụp thường đủ sáng từ camera chính

Bạn cũng có thể chụp ảnh ở chế độ 64MP.	Bạn cũng có thể chụp ảnh ở chế độ 64MP .

Kết quả bạn sẽ có hình ảnh sắc nét hơn và chi tiết hơn.	Kết quả bạn sẽ có hình ảnh sắc nét hơn và chi tiết hơn .
{"subject": [], "object": [], "aspect": ["6&&hình", "7&&ảnh"], "predicate": ["8&&sắc", "9&&nét", "10&&hơn"], "label": "COM+"}
{"subject": [], "object": [], "aspect": [], "predicate": ["12&&chi", "13&&tiết", "14&&hơn"], "label": "COM+"}

Nhưng đổi lại nó sẽ chiếm nhiều không gian lưu trữ hơn.	Nhưng đổi lại nó sẽ chiếm nhiều không gian lưu trữ hơn .
{"subject": ["4&&nó"], "object": [], "aspect": ["8&&không", "9&&gian", "10&&lưu", "11&&trữ"], "predicate": ["6&&chiếm", "7&&nhiều", "8&&không", "9&&gian", "10&&lưu", "11&&trữ", "12&&hơn"], "label": "COM-"}

Trong điều kiện ánh sáng yếu, Galaxy M51 vẫn cho hình ảnh chất lượng tốt.	Trong điều kiện ánh sáng yếu , Galaxy M51 vẫn cho hình ảnh chất lượng tốt .

Có chế độ ban đêm hỗ trợ cho việc chụp ảnh.	Có chế độ ban đêm hỗ trợ cho việc chụp ảnh .

Bạn sẽ có một hình ảnh có độ phơi sáng khá cao hơn, nâng cao chi tiết ở những vùng tối hơn.	Bạn sẽ có một hình ảnh có độ phơi sáng khá cao hơn , nâng cao chi tiết ở những vùng tối hơn .
{"subject": ["5&&hình", "6&&ảnh"], "object": [], "aspect": ["8&&độ", "9&&phơi", "10&&sáng"], "predicate": ["12&&cao", "13&&hơn"], "label": "COM+"}
{"subject": ["5&&hình", "6&&ảnh"], "object": [], "aspect": ["17&&chi", "18&&tiết", "19&&ở", "20&&những", "21&&vùng", "22&&tối"], "predicate": ["15&&nâng", "16&&cao", "17&&chi", "18&&tiết", "19&&ở", "20&&những", "21&&vùng", "22&&tối", "23&&hơn"], "label": "COM+"}

Đương nhiên khi bạn phong to hình ảnh lên sẽ thấy khá nhiều hạt mịn.	Đương nhiên khi bạn phong to hình ảnh lên sẽ thấy khá nhiều hạt mịn .

alt: Đánh giá điện thoại Samsung Galaxy M51	alt : Đánh giá điện thoại Samsung Galaxy M51

des: Đánh giá điện thoại Samsung Galaxy M51	des : Đánh giá điện thoại Samsung Galaxy M51

Ảnh chụp chế độ ban đêm từ camera chính	Ảnh chụp chế độ ban đêm từ camera chính

Nếu bạn chụp ảnh trong điều kiện ánh sáng đèn trong nhà thì hình ảnh cũng rất tốt.	Nếu bạn chụp ảnh trong điều kiện ánh sáng đèn trong nhà thì hình ảnh cũng rất tốt .

Nói chung không chê được điểm gì.	Nói chung không chê được điểm gì .

alt: Đánh giá điện thoại Samsung Galaxy M51	alt : Đánh giá điện thoại Samsung Galaxy M51

des: Đánh giá điện thoại Samsung Galaxy M51	des : Đánh giá điện thoại Samsung Galaxy M51

Ảnh chụp từ camera chính, ánh sáng đèn trong nhà	Ảnh chụp từ camera chính , ánh sáng đèn trong nhà

Camera góc cực rộng	Camera góc cực rộng

Camera góc cực rộng có một góc nhìn lên tới 123 độ, cho phép bạn lấy được trường ảnh rộng hơn khá nhiều so với các mẫu ultrawide khác.	Camera góc cực rộng có một góc nhìn lên tới 123 độ , cho phép bạn lấy được trường ảnh rộng hơn khá nhiều so với các mẫu ultrawide khác .
{"subject": ["1&&Camera", "2&&góc", "3&&cực", "4&&rộng"], "object": ["27&&các", "28&&mẫu", "29&&ultrawide", "30&&khác"], "aspect": ["19&&trường", "20&&ảnh"], "predicate": ["21&&rộng", "22&&hơn", "23&&khá", "24&&nhiều"], "label": "COM+"}

Nó giữ được màu sắc tốt và dải động khá cao.	Nó giữ được màu sắc tốt và dải động khá cao .

Có đôi khi các góc vẫn chưa thể so sánh được với camera chính nhưng nhìn chung là chấp nhận tốt.	Có đôi khi các góc vẫn chưa thể so sánh được với camera chính nhưng nhìn chung là chấp nhận tốt .

alt: Đánh giá điện thoại Samsung Galaxy M51	alt : Đánh giá điện thoại Samsung Galaxy M51

des: Đánh giá điện thoại Samsung Galaxy M51	des : Đánh giá điện thoại Samsung Galaxy M51

camera góc cục rộng chụp ban ngày	camera góc cục rộng chụp ban ngày

Chế độ ban đêm cũng được sử dụng với camera góc siêu rộng.	Chế độ ban đêm cũng được sử dụng với camera góc siêu rộng .

Bạn cũng nhận được hình ảnh khá tốt, tuy nhiên phóng to hình ảnh lên cũng sẽ thấy những điểm mờ hoặc hạt mịn.	Bạn cũng nhận được hình ảnh khá tốt , tuy nhiên phóng to hình ảnh lên cũng sẽ thấy những điểm mờ hoặc hạt mịn .

Nói chung hình ảnh sử dụng được nhưng không quá đẹp.	Nói chung hình ảnh sử dụng được nhưng không quá đẹp .

alt: Đánh giá điện thoại Samsung Galaxy M51	alt : Đánh giá điện thoại Samsung Galaxy M51

des: Đánh giá điện thoại Samsung Galaxy M51	des : Đánh giá điện thoại Samsung Galaxy M51

Ảnh chụp chế độ ban đêm góc cực rộng	Ảnh chụp chế độ ban đêm góc cực rộng

Camera Macro	Camera Macro

Nhờ một cảm biến macro 5MP, bạn sẽ có được những tấm ảnh đẹp với nhiều chi tiết và tái hiện màu sắc rất tốt.	Nhờ một cảm biến macro 5MP , bạn sẽ có được những tấm ảnh đẹp với nhiều chi tiết và tái hiện màu sắc rất tốt .

Đây là một ưu điểm khi xu thế hiện nay rất yêu thích chụp hình cận cảnh.	Đây là một ưu điểm khi xu thế hiện nay rất yêu thích chụp hình cận cảnh .

alt: Đánh giá điện thoại Samsung Galaxy M51	alt : Đánh giá điện thoại Samsung Galaxy M51

des: Đánh giá điện thoại Samsung Galaxy M51	des : Đánh giá điện thoại Samsung Galaxy M51

Ảnh chụp Macro	Ảnh chụp Macro

Tuy nhiên đây là một ống kính tiêu cự cố định nên không có khả năng tự động lấy nét.	Tuy nhiên đây là một ống kính tiêu cự cố định nên không có khả năng tự động lấy nét .

Vì vậy bạn cần đưa ống kính tới đúng tiêu cự và duy trì để lấy nét chính xác mới có hình ảnh đẹp được.	Vì vậy bạn cần đưa ống kính tới đúng tiêu cự và duy trì để lấy nét chính xác mới có hình ảnh đẹp được .

Chân dung	Chân dung

Chế độ Live Focus của Samsung cho phép bạn chụp chân dung.	Chế độ Live Focus của Samsung cho phép bạn chụp chân dung .

Hơn nữa bạn còn có thể xem trước độ mờ của background.	Hơn nữa bạn còn có thể xem trước độ mờ của background .

Cảm biến phát hiện cạnh tốt, tất nhiên là chủ thể phải đứng yên.	Cảm biến phát hiện cạnh tốt , tất nhiên là chủ thể phải đứng yên .

Ngoài ra bạn còn có tùy chọn để thay đổi độ mờ và kiểu mờ sau khi đã chụp ảnh xong.	Ngoài ra bạn còn có tùy chọn để thay đổi độ mờ và kiểu mờ sau khi đã chụp ảnh xong .

alt: Đánh giá điện thoại Samsung Galaxy M51	alt : Đánh giá điện thoại Samsung Galaxy M51

des: Đánh giá điện thoại Samsung Galaxy M51	des : Đánh giá điện thoại Samsung Galaxy M51

Ảnh chân dung camera sau từ Galaxy M51	Ảnh chân dung camera sau từ Galaxy M51

Camera trước	Camera trước

Camera selfie dùng cảm biến Sony IMX616 32MP tạo ra hình ảnh mặc định 8MP, nhưng bạn cùng có thể chọn chế độ chụp 32MP đấy.	Camera selfie dùng cảm biến Sony IMX616 32MP tạo ra hình ảnh mặc định 8MP , nhưng bạn cùng có thể chọn chế độ chụp 32MP đấy .

alt:	alt :

des:	des :

Ảnh selfie thường	Ảnh selfie thường

Chất lượng hình ảnh rất tốt với camera selfie này.	Chất lượng hình ảnh rất tốt với camera selfie này .

Nhưng có một điều đặc biệt chính là bạn đang chỉ có một ống kính thường và bạn vẫn có thể chụp góc rộng selfie.	Nhưng có một điều đặc biệt chính là bạn đang chỉ có một ống kính thường và bạn vẫn có thể chụp góc rộng selfie .

alt:	alt :

des:	des :

Ảnh Selfie góc gộng	Ảnh Selfie góc gộng

Quay video	Quay video

Video 4K ở tốc độ 30 khung hình / giây và 1080p ở tốc độ 30 khung hình / giây có chất lượng tuyệt vời.	Video 4K ở tốc độ 30 khung hình / giây và 1080p ở tốc độ 30 khung hình / giây có chất lượng tuyệt vời .

Mặc dù Samsung không đầu tư chống rung quang học nhưng lại có EIS rất tốt nên hình ảnh rất ổn định và cho chất lượng cao.	Mặc dù Samsung không đầu tư chống rung quang học nhưng lại có EIS rất tốt nên hình ảnh rất ổn định và cho chất lượng cao .

Tuổi thọ pin	Tuổi thọ pin

Điện thoại Samsung Galaxy M51 được trang bị viên pin khủng nhất trên thị trường hiện nay nhờ một bước đột phá trong thiết kế.	Điện thoại Samsung Galaxy M51 được trang bị viên pin khủng nhất trên thị trường hiện nay nhờ một bước đột phá trong thiết kế .
{"subject": ["3&&Samsung", "4&&Galaxy", "5&&M51"], "object": [], "aspect": ["9&&viên", "10&&pin"], "predicate": ["11&&khủng", "12&&nhất", "13&&trên", "14&&thị", "15&&trường", "16&&hiện", "17&&nay"], "label": "SUP+"}

Với viên pin này thì chắc chắn bạn sẽ có một thời lượng pin khủng để sử dụng và nếu như mức sử dụng của bạn ở mức trung bình thì dùng 2-3 ngày là quá bình thường rồi.	Với viên pin này thì chắc chắn bạn sẽ có một thời lượng pin khủng để sử dụng và nếu như mức sử dụng của bạn ở mức trung bình thì dùng 2 - 3 ngày là quá bình thường rồi .

alt: Samsung Galaxy M51	alt : Samsung Galaxy M51

des: Samsung Galaxy M51	des : Samsung Galaxy M51

Điểm đặc biệt khác của điện thoại này nằm ở bộ sạc của nó.	Điểm đặc biệt khác của điện thoại này nằm ở bộ sạc của nó .

Đó là bộ sạc C to C khá đặc biệt trên thị trường.	Đó là bộ sạc C to C khá đặc biệt trên thị trường .

Với cấu tạo này thì bạn sẽ không cần mua thêm một cáp khác để thực hiện sạc ngược mà dùng luôn cáp này sạc ngược cho một điện thoại có chân tpye C khác.	Với cấu tạo này thì bạn sẽ không cần mua thêm một cáp khác để thực hiện sạc ngược mà dùng luôn cáp này sạc ngược cho một điện thoại có chân tpye C khác .

Nó đi kèm sạc nhanh 25W, vẫn là nhanh nhưng đối với viên pin 7000 mAh. Galaxy M51 mất 115 phút để sạc từ 0% lên 100% với bộ sạc nhanh 25W đi kèm.	Nó đi kèm sạc nhanh 25W , vẫn là nhanh nhưng đối với viên pin 7000 mAh . Galaxy M51 mất 115 phút để sạc từ 0% lên 100% với bộ sạc nhanh 25W đi kèm .

Đây là nói đang sạc cho một viên pin khủng đấy nhé.	Đây là nói đang sạc cho một viên pin khủng đấy nhé .

Khi chúng ta có thời lương pin cực lớn như thế này rồi thì vấn đề sạc không cần quá nhanh vì khi chịu tải sạc nhanh thì tuổi thọ về lâu dài của viên pin sẽ kém hơn.	Khi chúng ta có thời lương pin cực lớn như thế này rồi thì vấn đề sạc không cần quá nhanh vì khi chịu tải sạc nhanh thì tuổi thọ về lâu dài của viên pin sẽ kém hơn .

Bởi vậy để nói một cục sạc 65W hay 25W thì tất nhiên sạc 65W sẽ nhanh chóng gây “chai” pin hơn đấy.	Bởi vậy để nói một cục sạc 65W hay 25W thì tất nhiên sạc 65W sẽ nhanh chóng gây “ chai ” pin hơn đấy .
{"subject": ["14&&sạc", "15&&65W"], "object": ["10&&25W"], "aspect": ["19&&gây", "20&&“", "21&&chai", "22&&”", "23&&pin"], "predicate": ["24&&hơn"], "label": "COM-"}

So sánh với đối thủ	So sánh với đối thủ

Hiện tại chiếc Samsung Galaxy M51 mới ra mắt tại Ấn Độ và mức giá đâu đó tầm 8 triệu và với mức giá này bạn vẫn có những lựa chọn khác cho bản thân.	Hiện tại chiếc Samsung Galaxy M51 mới ra mắt tại Ấn Độ và mức giá đâu đó tầm 8 triệu và với mức giá này bạn vẫn có những lựa chọn khác cho bản thân .

Tất nhiên những lựa chọn đó nhằm vào nhu cầu riêng về một mảng nào đó mà thôi.	Tất nhiên những lựa chọn đó nhằm vào nhu cầu riêng về một mảng nào đó mà thôi .

Vivo V19	Vivo V19

Đầu tiên trong danh sách chúng ta sẽ có chiếc  Vivo V19  ở cùng một mức giá.	Đầu tiên trong danh sách chúng ta sẽ có chiếc Vivo V19 ở cùng một mức giá .
{"subject": [], "object": ["11&&Vivo", "12&&V19"], "aspect": ["16&&mức", "17&&giá"], "predicate": ["14&&cùng", "15&&một"], "label": "EQL"}

Chiếc điện thoại này có một vài ưu thế lớn như một màn hình có độ sáng cực cao, hoàn thiện 2 mặt kính cao cấp hơn và camera selfie kép đẳng cấp.	Chiếc điện thoại này có một vài ưu thế lớn như một màn hình có độ sáng cực cao , hoàn thiện 2 mặt kính cao cấp hơn và camera selfie kép đẳng cấp .
{"subject": ["1&&Chiếc", "2&&điện", "3&&thoại", "4&&này"], "object": [], "aspect": ["21&&hoàn", "22&&thiện", "23&&2", "24&&mặt", "25&&kính"], "predicate": ["26&&cao", "27&&cấp", "28&&hơn"], "label": "COM+"}

Tuy nhiên những mặt khác tỏ ra yếu đuối hơn Galaxy M51 một chút.	Tuy nhiên những mặt khác tỏ ra yếu đuối hơn Galaxy M51 một chút .
{"subject": [], "object": ["11&&Galaxy", "12&&M51"], "aspect": ["3&&những", "4&&mặt", "5&&khác"], "predicate": ["8&&yếu", "9&&đuối", "10&&hơn"], "label": "COM-"}

Đó là một bộ xử lý chậm hơn với Snapdragon 712, phần cứng camera sau yếu hơn.	Đó là một bộ xử lý chậm hơn với Snapdragon 712 , phần cứng camera sau yếu hơn .
{"subject": [], "object": [], "aspect": ["4&&bộ", "5&&xử", "6&&lý"], "predicate": ["7&&chậm", "8&&hơn"], "label": "COM-"}
{"subject": [], "object": [], "aspect": ["13&&phần", "14&&cứng", "15&&camera", "16&&sau"], "predicate": ["17&&yếu", "18&&hơn"], "label": "COM-"}

Tất nhiên nói về pin thì chẳng có máy nào so sánh được với viên pin 7.000 mAh của M51.	Tất nhiên nói về pin thì chẳng có máy nào so sánh được với viên pin 7.000 mAh của M51 .
{"subject": ["20&&M51"], "object": [], "aspect": ["5&&pin"], "predicate": ["7&&chẳng", "8&&có", "9&&máy", "10&&nào", "11&&so", "12&&sánh", "13&&được"], "label": "SUP+"}

Realme 6 Pro	Realme 6 Pro

Tiếp tục là chiếc  Realme 6 Pro  cũng có mức giá tương đương.	Tiếp tục là chiếc Realme 6 Pro cũng có mức giá tương đương .
{"subject": ["5&&Realme", "6&&6", "7&&Pro"], "object": [], "aspect": ["10&&mức", "11&&giá"], "predicate": ["12&&tương", "13&&đương"], "label": "EQL"}

Nó được hoàn thiện 2 mặt kính, một màn hình 90Hz mượt mà hơn, trang bị ống kính tele, camera selfie kép đẳng cấp hơn, sạc nhanh hơn.	Nó được hoàn thiện 2 mặt kính , một màn hình 90Hz mượt mà hơn , trang bị ống kính tele , camera selfie kép đẳng cấp hơn , sạc nhanh hơn .
{"subject": ["1&&Nó"], "object": [], "aspect": ["10&&màn", "11&&hình"], "predicate": ["13&&mượt", "14&&mà", "15&&hơn"], "label": "COM+"}
{"subject": ["1&&Nó"], "object": [], "aspect": ["23&&camera", "24&&selfie"], "predicate": ["26&&đẳng", "27&&cấp", "28&&hơn"], "label": "COM+"}
{"subject": ["1&&Nó"], "object": [], "aspect": ["30&&sạc"], "predicate": ["31&&nhanh", "32&&hơn"], "label": "COM+"}

Nhưng ngược lại bạn sẽ chỉ có một màn hình IPS LCD, bộ xử lý Snapdragon 720G thấp hơn một bậc.	Nhưng ngược lại bạn sẽ chỉ có một màn hình IPS LCD , bộ xử lý Snapdragon 720G thấp hơn một bậc .
{"subject": [], "object": [], "aspect": ["14&&bộ", "15&&xử", "16&&lý"], "predicate": ["19&&thấp", "20&&hơn", "21&&một", "22&&bậc"], "label": "COM-"}

Tất nhiên sạc nhanh 30W thì nhanh hơn nhưng dung lượng pin thì gặp “ông nội” rồi.	Tất nhiên sạc nhanh 30W thì nhanh hơn nhưng dung lượng pin thì gặp “ ông nội ” rồi .
{"subject": [], "object": [], "aspect": ["3&&sạc", "4&&nhanh"], "predicate": ["7&&nhanh", "8&&hơn"], "label": "COM+"}

OPPO A93	OPPO A93

Oppo A93  là một lựa chọn khác nhưng nó có mức giá rẻ hơn một chút.	Oppo A93 là một lựa chọn khác nhưng nó có mức giá rẻ hơn một chút .
{"subject": ["9&&nó"], "object": [], "aspect": ["11&&mức", "12&&giá"], "predicate": ["13&&rẻ", "14&&hơn", "15&&một", "16&&chút"], "label": "COM+"}

Vẫn là hoàn thiện hai mặt kính cao cấp hơn, bộ xử lý tương đương nhau nhưng nó có camera selfie kép tốt hơn để chụp chân dung.	Vẫn là hoàn thiện hai mặt kính cao cấp hơn , bộ xử lý tương đương nhau nhưng nó có camera selfie kép tốt hơn để chụp chân dung .
{"subject": ["19&&nó"], "object": [], "aspect": ["3&&hoàn", "4&&thiện", "5&&hai", "6&&mặt", "7&&kính"], "predicate": ["8&&cao", "9&&cấp", "10&&hơn"], "label": "COM+"}
{"subject": ["19&&nó"], "object": [], "aspect": ["12&&bộ", "13&&xử", "14&&lý"], "predicate": ["15&&tương", "16&&đương", "17&&nhau"], "label": "EQL"}
{"subject": ["19&&nó"], "object": [], "aspect": ["21&&camera", "22&&selfie"], "predicate": ["24&&tốt", "25&&hơn"], "label": "COM+"}

Ngược lại nói về pin thì bạn không cần so sánh nhiều vì 7.000 mAh là không ai vượt nổi rồi.	Ngược lại nói về pin thì bạn không cần so sánh nhiều vì 7.000 mAh là không ai vượt nổi rồi .
{"subject": [], "object": [], "aspect": ["5&&pin"], "predicate": ["17&&không", "18&&ai", "19&&vượt", "20&&nổi"], "label": "SUP+"}

Thêm vào đó là một màn hình hiển thị đẹp hơn và lớn hơn cùng với phần cứng camera sau mạnh mẽ hơn là những lợi thế của Galaxy M51.	Thêm vào đó là một màn hình hiển thị đẹp hơn và lớn hơn cùng với phần cứng camera sau mạnh mẽ hơn là những lợi thế của Galaxy M51 .
{"subject": ["29&&Galaxy", "30&&M51"], "object": [], "aspect": ["6&&màn", "7&&hình", "8&&hiển", "9&&thị"], "predicate": ["10&&đẹp", "11&&hơn"], "label": "COM+"}
{"subject": ["29&&Galaxy", "30&&M51"], "object": [], "aspect": ["6&&màn", "7&&hình", "8&&hiển", "9&&thị"], "predicate": ["13&&lớn", "14&&hơn"], "label": "COM+"}
{"subject": ["29&&Galaxy", "30&&M51"], "object": [], "aspect": ["17&&phần", "18&&cứng", "19&&camera", "20&&sau"], "predicate": ["21&&mạnh", "22&&mẽ", "23&&hơn"], "label": "COM+"}

Xiaomi Redmi Note 9 Pro	Xiaomi Redmi Note 9 Pro

Cuối cùng chúng ta sẽ nói về chiếc Xiaomi Redmi Note 9 Pro.	Cuối cùng chúng ta sẽ nói về chiếc Xiaomi Redmi Note 9 Pro .

Nó cũng có mặt sau bằng nhựa với khung nhôm nhưng lại có IP53 chống sốc rất tốt.	Nó cũng có mặt sau bằng nhựa với khung nhôm nhưng lại có IP53 chống sốc rất tốt .

Một màn hình IPS LCD hiển thị yếu hơn nhưng lại có tốc độ làm mới tới 120Hz và độ sáng cao.	Một màn hình IPS LCD hiển thị yếu hơn nhưng lại có tốc độ làm mới tới 120Hz và độ sáng cao .
{"subject": [], "object": [], "aspect": ["2&&màn", "3&&hình"], "predicate": ["6&&hiển", "7&&thị", "8&&yếu", "9&&hơn"], "label": "COM-"}
{"subject": ["2&&màn", "3&&hình", "4&&IPS", "5&&LCD"], "object": [], "aspect": ["6&&hiển", "7&&thị"], "predicate": ["8&&yếu", "9&&hơn"], "label": "COM-"}

Bộ xử lý Snapdragon 732G mạnh mẽ hơn một chút so với 730G và nó cũng là tối ưu hóa chơi game hơn.	Bộ xử lý Snapdragon 732G mạnh mẽ hơn một chút so với 730G và nó cũng là tối ưu hóa chơi game hơn .
{"subject": ["1&&Bộ", "2&&xử", "3&&lý", "4&&Snapdragon", "5&&732G"], "object": ["13&&730G"], "aspect": [], "predicate": ["6&&mạnh", "7&&mẽ", "8&&hơn", "9&&một", "10&&chút"], "label": "COM+"}

Phần cứng camera tương đương nhưng macro cùng selfie có độ phân giải thấp hơn.	Phần cứng camera tương đương nhưng macro cùng selfie có độ phân giải thấp hơn .
{"subject": [], "object": [], "aspect": ["1&&Phần", "2&&cứng", "3&&camera"], "predicate": ["4&&tương", "5&&đương"], "label": "EQL"}
{"subject": [], "object": [], "aspect": ["7&&macro"], "predicate": ["11&&độ", "12&&phân", "13&&giải", "14&&thấp", "15&&hơn"], "label": "COM-"}
{"subject": [], "object": [], "aspect": ["9&&selfie"], "predicate": ["11&&độ", "12&&phân", "13&&giải", "14&&thấp", "15&&hơn"], "label": "COM-"}
{"subject": ["7&&macro"], "object": [], "aspect": ["11&&độ", "12&&phân", "13&&giải"], "predicate": ["14&&thấp", "15&&hơn"], "label": "COM-"}
{"subject": ["9&&selfie"], "object": [], "aspect": ["11&&độ", "12&&phân", "13&&giải"], "predicate": ["14&&thấp", "15&&hơn"], "label": "COM-"}

Pin thì không thể so sánh với pin của M51 rồi.	Pin thì không thể so sánh với pin của M51 rồi .
{"subject": [], "object": ["10&&M51"], "aspect": ["1&&Pin"], "predicate": ["3&&không", "4&&thể", "5&&so", "6&&sánh", "7&&với"], "label": "COM-"}

Giá và địa chỉ bán	Giá và địa chỉ bán

Kết luận	Kết luận

Samsung Galaxy M51 được đánh giá là khá toàn diện trong phân khúc tầm trung.	Samsung Galaxy M51 được đánh giá là khá toàn diện trong phân khúc tầm trung .

Nó đang nắm giữ vô địch về dung lượng và thời lượng pin, vì thế rất thích hợp để bạn sử dụng lâu dài mà không cần lo lắng nhiều về sạc.	Nó đang nắm giữ vô địch về dung lượng và thời lượng pin , vì thế rất thích hợp để bạn sử dụng lâu dài mà không cần lo lắng nhiều về sạc .

Thêm vào đó là một màn hình lớn và bộ xử lý mạnh mẽ, tối ưu hóa chơi game làm bạn thoải mái giải trí.	Thêm vào đó là một màn hình lớn và bộ xử lý mạnh mẽ , tối ưu hóa chơi game làm bạn thoải mái giải trí .

Chụp ảnh cũng đẹp và đa năng với chụp macro nổi bật và chi tiết nhiều hơn.	Chụp ảnh cũng đẹp và đa năng với chụp macro nổi bật và chi tiết nhiều hơn .
{"subject": [], "object": [], "aspect": ["9&&chụp", "10&&macro"], "predicate": ["14&&chi", "15&&tiết", "16&&nhiều", "17&&hơn"], "label": "COM+"}
{"subject": ["9&&chụp", "10&&macro"], "object": [], "aspect": ["14&&chi", "15&&tiết"], "predicate": ["16&&nhiều", "17&&hơn"], "label": "COM+"}

