title: So sánh Samsung Galaxy A12 và Galaxy A13, điện thoại nào tốt hơn?	title : So sánh Samsung Galaxy A12 và Galaxy A13 , điện thoại nào tốt hơn ?

Hai dòng điện thoại  Samsung  Galaxy A12 và Samsung Galaxy A13 rất được ưa chuộng vì chất lượng và giá thành.	Hai dòng điện thoại Samsung Galaxy A12 và Samsung Galaxy A13 rất được ưa chuộng vì chất lượng và giá thành .

Giữa 2 chiếc  điện thoại thông minh  ra mắt gần nhau như vậy, bạn nên mua điện thoại nào.	Giữa 2 chiếc điện thoại thông minh ra mắt gần nhau như vậy , bạn nên mua điện thoại nào .

Bài so sánh dưới đây có thể giúp bạn lựa chọn một chiếc điện thoại phù hợp.	Bài so sánh dưới đây có thể giúp bạn lựa chọn một chiếc điện thoại phù hợp .

1.	1 .

Đôi nét về điện thoại Samsung Galaxy A12	Đôi nét về điện thoại Samsung Galaxy A12

- Thời gian ra mắt	- Thời gian ra mắt

Điện thoại Samsung Galaxy A12  được ra mắt vào tháng  10/2021	Điện thoại Samsung Galaxy A12 được ra mắt vào tháng 10 / 2021

- Phân khúc sản phẩm	- Phân khúc sản phẩm

Đây là dòng điện thoại thuộc  phân khúc giá rẻ  của Samsung, với giá thành  dưới 5 triệu đồng , chiếc điện thoại này phù hợp với túi tiền của nhiều người sử dụng và được ưa chuộng.	Đây là dòng điện thoại thuộc phân khúc giá rẻ của Samsung , với giá thành dưới 5 triệu đồng , chiếc điện thoại này phù hợp với túi tiền của nhiều người sử dụng và được ưa chuộng .

alt: Điện thoại Samsung Galaxy A12 thuộc phân khúc giá rẻ	alt : Điện thoại Samsung Galaxy A12 thuộc phân khúc giá rẻ

des: Điện thoại Samsung Galaxy A12 thuộc phân khúc giá rẻ	des : Điện thoại Samsung Galaxy A12 thuộc phân khúc giá rẻ

Điện thoại Samsung Galaxy A12 thuộc phân khúc giá rẻ.	Điện thoại Samsung Galaxy A12 thuộc phân khúc giá rẻ .

- Đôi nét về thiết kế	- Đôi nét về thiết kế

Vỏ điện thoại được làm bằng nhựa, giữa 2 mặt không có khung viền kim loại ngăn cách tạo ra cảm giác nhẹ nhàng nhưng vẫn chắc chắn.	Vỏ điện thoại được làm bằng nhựa , giữa 2 mặt không có khung viền kim loại ngăn cách tạo ra cảm giác nhẹ nhàng nhưng vẫn chắc chắn .

Mặt lưng được  phủ nhám  để hạn chế dấu vân tay.	Mặt lưng được phủ nhám để hạn chế dấu vân tay .

4 camera  được sắp xếp gọn nằm trong khung vuông bên góc của trái vỏ điện thoại vô cùng bắt mắt và tinh tế.	4 camera được sắp xếp gọn nằm trong khung vuông bên góc của trái vỏ điện thoại vô cùng bắt mắt và tinh tế .

Dòng điện thoại này có các màu nổi bật phù hợp với nhiều lứa tuổi:  Trắng, đen, xanh dương .	Dòng điện thoại này có các màu nổi bật phù hợp với nhiều lứa tuổi : Trắng , đen , xanh dương .

alt: Màu sắc đơn giản, hiện đại	alt : Màu sắc đơn giản , hiện đại

des: Màu sắc đơn giản, hiện đại	des : Màu sắc đơn giản , hiện đại

Màu sắc đơn giản, hiện đại.	Màu sắc đơn giản , hiện đại .

- Thông số nổi bật	- Thông số nổi bật

Điện thoại được trang bị hệ thống camera: Độ phân giải camera sau lên đến  48 MP ,  5 MP ,  2 MP ,  2 MP  và camera trước  8 MP .	Điện thoại được trang bị hệ thống camera : Độ phân giải camera sau lên đến 48 MP , 5 MP , 2 MP , 2 MP và camera trước 8 MP .

Màn hình  độ phân giải  cao, sử dụng công nghệ màn hình  PLS TFT LCD , kích thước màn hình  6.5 inch .	Màn hình độ phân giải cao , sử dụng công nghệ màn hình PLS TFT LCD , kích thước màn hình 6.5 inch .

Bộ nhớ trong 128GB giúp người sử dụng thoải mái lưu trữ hình ảnh, các ứng dụng và nội dung yêu thích.	Bộ nhớ trong 128GB giúp người sử dụng thoải mái lưu trữ hình ảnh , các ứng dụng và nội dung yêu thích .

Dung lượng pin  5000 mAh  có thể thoải mái sử dụng cả ngày mà không lo hết pin.	Dung lượng pin 5000 mAh có thể thoải mái sử dụng cả ngày mà không lo hết pin .

2.	2 .

Đôi nét về điện thoại Samsung Galaxy A13	Đôi nét về điện thoại Samsung Galaxy A13

- Thời gian ra mắt:  Được ra mắt vào tháng  03/2022	- Thời gian ra mắt : Được ra mắt vào tháng 03 / 2022

- Phân khúc sản phẩm	- Phân khúc sản phẩm

Điện thoại Samsung Galaxy A13  cũng thuộc  phân khúc sản phẩm giá rẻ  nhưng đã có thêm những cải tiến so với các dòng điện thoại trước đây làm hài lòng người sử dụng.	Điện thoại Samsung Galaxy A13 cũng thuộc phân khúc sản phẩm giá rẻ nhưng đã có thêm những cải tiến so với các dòng điện thoại trước đây làm hài lòng người sử dụng .
{"subject": ["3&&Samsung", "4&&Galaxy", "5&&A13"], "object": ["23&&các", "24&&dòng", "25&&điện", "26&&thoại", "27&&trước", "28&&đây"], "aspect": [], "predicate": ["16&&có", "17&&thêm", "18&&những", "19&&cải", "20&&tiến"], "label": "COM+"}

- Đôi nét về thiết kế	- Đôi nét về thiết kế

Thiết kế điện thoại mỏng nhẹ, thanh lịch.	Thiết kế điện thoại mỏng nhẹ , thanh lịch .

Viền điện thoại được bo vào trong tạo ra sự chắc chắn và dễ cầm nắm cho người sử dụng.	Viền điện thoại được bo vào trong tạo ra sự chắc chắn và dễ cầm nắm cho người sử dụng .

Điện thoại Samsung Galaxy A13 có các màu:  Cam, đen, xanh mint .	Điện thoại Samsung Galaxy A13 có các màu : Cam , đen , xanh mint .

Camera trước được thiết kế hình giọt nước nằm sát viền trên của màn hình và 4 camera sau nằm góc trái của mặt sau điện thoại.	Camera trước được thiết kế hình giọt nước nằm sát viền trên của màn hình và 4 camera sau nằm góc trái của mặt sau điện thoại .

alt: Thiết kế tinh tế, sang trọng	alt : Thiết kế tinh tế , sang trọng

des: Thiết kế tinh tế, sang trọng	des : Thiết kế tinh tế , sang trọng

Thiết kế tinh tế, sang trọng.	Thiết kế tinh tế , sang trọng .

- Thông số nổi bật	- Thông số nổi bật

4 camera có độ phân giải cao, lên đến  50 MP ,  5 MP ,  2 MP ,  2 MP  và camera trước là  8 MP .	4 camera có độ phân giải cao , lên đến 50 MP , 5 MP , 2 MP , 2 MP và camera trước là 8 MP .

Camera hỗ trợ những tính năng nổi bật như chụp ban đem, quay siêu chậm, trôi nhanh thời gian,...	Camera hỗ trợ những tính năng nổi bật như chụp ban đem , quay siêu chậm , trôi nhanh thời gian , . . .

Điện thoại có độ sáng tối đa  600 nits , bộ nhớ trong  128GB .	Điện thoại có độ sáng tối đa 600 nits , bộ nhớ trong 128GB .

Với dung lượng pin  5000 mAh  kèm hỗ trợ sạc 15W, dòng điện thoại này giúp gia tăng trải nghiệm của người sử dụng.	Với dung lượng pin 5000 mAh kèm hỗ trợ sạc 15W , dòng điện thoại này giúp gia tăng trải nghiệm của người sử dụng .

3.	3 .

So sánh Samsung Galaxy A12 và Samsung Galaxy A13	So sánh Samsung Galaxy A12 và Samsung Galaxy A13

Thiết kế	Thiết kế

Cả 2 dòng điện thoại đều hướng đến đối tượng người sử dụng ở nhiều lứa tuổi, đáp ứng nhiều sở thích khác nhau.	Cả 2 dòng điện thoại đều hướng đến đối tượng người sử dụng ở nhiều lứa tuổi , đáp ứng nhiều sở thích khác nhau .

Màu sắc của cả 2 dòng đều là những màu cơ bản, hiện đại nên rất dễ sử dụng.	Màu sắc của cả 2 dòng đều là những màu cơ bản , hiện đại nên rất dễ sử dụng .

Kích thước của 2 dòng điện thoại thoại không có quá nhiều sự khác biệt, đều đem đến cho người sử dụng cảm giác mỏng nhẹ và dễ dàng cầm nắm.	Kích thước của 2 dòng điện thoại thoại không có quá nhiều sự khác biệt , đều đem đến cho người sử dụng cảm giác mỏng nhẹ và dễ dàng cầm nắm .
{"subject": ["4&&2", "5&&dòng", "6&&điện", "7&&thoại"], "object": ["4&&2", "5&&dòng", "6&&điện", "7&&thoại"], "aspect": ["1&&Kích", "2&&thước"], "predicate": ["9&&không", "10&&có", "11&&quá", "12&&nhiều", "13&&sự", "14&&khác", "15&&biệt"], "label": "EQL"}

Điện thoại Samsung Galaxy A12 có kích thước là  164mm  x  75.8mm  x  8.9mm , trọng lượng  205g .	Điện thoại Samsung Galaxy A12 có kích thước là 164mm x 75.8mm x 8.9mm , trọng lượng 205g .

alt: Kích thước điện thoại Samsung Galaxy A12 vừa tay	alt : Kích thước điện thoại Samsung Galaxy A12 vừa tay

des: Kích thước điện thoại Samsung Galaxy A12 vừa tay	des : Kích thước điện thoại Samsung Galaxy A12 vừa tay

Kích thước điện thoại Samsung Galaxy A12 vừa tay.	Kích thước điện thoại Samsung Galaxy A12 vừa tay .

Kích thước của điện thoại Samsung Galaxy A13 là  165.1mm  x  76.4mm  x  8.8mm , có trọng lượng nhẹ hơn với  195g .	Kích thước của điện thoại Samsung Galaxy A13 là 165.1mm x 76.4mm x 8.8mm , có trọng lượng nhẹ hơn với 195g .
{"subject": ["4&&điện", "5&&thoại", "6&&Samsung", "7&&Galaxy", "8&&A13"], "object": [], "aspect": ["17&&trọng", "18&&lượng"], "predicate": ["19&&nhẹ", "20&&hơn"], "label": "COM+"}

alt: Thiết kế điện thoại Samsung Galaxy A13 mỏng nhẹ, dễ sử dụng	alt : Thiết kế điện thoại Samsung Galaxy A13 mỏng nhẹ , dễ sử dụng

des: Thiết kế điện thoại Samsung Galaxy A13 mỏng nhẹ, dễ sử dụng	des : Thiết kế điện thoại Samsung Galaxy A13 mỏng nhẹ , dễ sử dụng

Thiết kế điện thoại Samsung Galaxy A13 mỏng nhẹ, dễ sử dụng.	Thiết kế điện thoại Samsung Galaxy A13 mỏng nhẹ , dễ sử dụng .

Màn hình	Màn hình

Với độ phân giải cao và màn hình rộng, cả 2 chiếc điện thoại đều khiến người sử dụng hài lòng, có trải nghiệm vô cùng tốt khi chất lượng hình ảnh hiện thị sắc nét và sống động.	Với độ phân giải cao và màn hình rộng , cả 2 chiếc điện thoại đều khiến người sử dụng hài lòng , có trải nghiệm vô cùng tốt khi chất lượng hình ảnh hiện thị sắc nét và sống động .

Điện thoại Samsung Galaxy A12 có màn hình  6.5 inch , sử dụng công nghệ màn hình  PLS TFT LCD  hiện đại, độ phân giải  HD+  (720  x  1600 Pixels) .	Điện thoại Samsung Galaxy A12 có màn hình 6.5 inch , sử dụng công nghệ màn hình PLS TFT LCD hiện đại , độ phân giải HD + ( 720 x 1600 Pixels ) .

alt: Màn hình Samsung Galaxy A12 độ phân giải cao	alt : Màn hình Samsung Galaxy A12 độ phân giải cao

des: Màn hình Samsung Galaxy A12 độ phân giải cao	des : Màn hình Samsung Galaxy A12 độ phân giải cao

Màn hình Samsung Galaxy A12 độ phân giải cao.	Màn hình Samsung Galaxy A12 độ phân giải cao .

Do ra đời sau đó, điện thoại Samsung Galaxy A13 đã có những cải tiến hơn nữa càng làm tăng trải nghiệm của người sử dụng.	Do ra đời sau đó , điện thoại Samsung Galaxy A13 đã có những cải tiến hơn nữa càng làm tăng trải nghiệm của người sử dụng .

Kích thước màn hình  6.6 inch , công nghệ màn hình  IPS LCD  với độ phân giải Full HD+  (1080  x  2408 Pixels) .	Kích thước màn hình 6.6 inch , công nghệ màn hình IPS LCD với độ phân giải Full HD + ( 1080 x 2408 Pixels ) .

alt: Màn hình sắc nét, hình ảnh chân thật	alt : Màn hình sắc nét , hình ảnh chân thật

des: Màn hình sắc nét, hình ảnh chân thật	des : Màn hình sắc nét , hình ảnh chân thật

Màn hình sắc nét, hình ảnh chân thật.	Màn hình sắc nét , hình ảnh chân thật .

Camera	Camera

Cả 2 dòng điện thoại đều được trang bị 4 camera nhưng có sự khác nhau về bố cục.	Cả 2 dòng điện thoại đều được trang bị 4 camera nhưng có sự khác nhau về bố cục .
{"subject": ["1&&Cả", "2&&2", "3&&dòng", "4&&điện", "5&&thoại"], "object": ["1&&Cả", "2&&2", "3&&dòng", "4&&điện", "5&&thoại"], "aspect": ["10&&4", "11&&camera"], "predicate": ["6&&đều", "7&&được", "8&&trang", "9&&bị"], "label": "EQL"}
{"subject": ["1&&Cả", "2&&2", "3&&dòng", "4&&điện", "5&&thoại"], "object": ["1&&Cả", "2&&2", "3&&dòng", "4&&điện", "5&&thoại"], "aspect": ["18&&bố", "19&&cục"], "predicate": ["14&&sự", "15&&khác", "16&&nhau"], "label": "DIF"}

Camera của điện thoại Samsung Galaxy A12 là thiết kế đầu tiên của hãng được thiết kế thành một cụm hình vuông.	Camera của điện thoại Samsung Galaxy A12 là thiết kế đầu tiên của hãng được thiết kế thành một cụm hình vuông .

Camera chính có độ phân giải  48 MP , một camera chụp góc rộng  5 MP , một camera đo chiều sâu  2 MP .	Camera chính có độ phân giải 48 MP , một camera chụp góc rộng 5 MP , một camera đo chiều sâu 2 MP .

Camera trước hỗ trợ tính năng selfie 8 MP.	Camera trước hỗ trợ tính năng selfie 8 MP .

Những tính năng nổi bật:  HDR , xóa phông, lấy nét, chụp góc rộng và góc siêu rộng.	Những tính năng nổi bật : HDR , xóa phông , lấy nét , chụp góc rộng và góc siêu rộng .

alt: Camera điện thoại Samsung Galaxy A12	alt : Camera điện thoại Samsung Galaxy A12

des: Camera điện thoại Samsung Galaxy A12	des : Camera điện thoại Samsung Galaxy A12

Camera điện thoại Samsung Galaxy A12.	Camera điện thoại Samsung Galaxy A12 .

Độ phân giải camera của điện thoại Samsung Galaxy A13 gần giống với chiếc điện thoại trước đó nhưng có camera chính  50 MP .	Độ phân giải camera của điện thoại Samsung Galaxy A13 gần giống với chiếc điện thoại trước đó nhưng có camera chính 50 MP .
{"subject": ["6&&điện", "7&&thoại", "8&&Samsung", "9&&Galaxy", "10&&A13"], "object": ["14&&chiếc", "15&&điện", "16&&thoại", "17&&trước", "18&&đó"], "aspect": ["1&&Độ", "2&&phân", "3&&giải", "4&&camera"], "predicate": ["11&&gần", "12&&giống"], "label": "EQL"}

Dòng điện thoại này được hỗ trợ thêm những tính năng nổi bật mới như: Hỗ trợ chụp ban đem, toàn cảnh và làm đẹp,...	Dòng điện thoại này được hỗ trợ thêm những tính năng nổi bật mới như : Hỗ trợ chụp ban đem , toàn cảnh và làm đẹp , . . .

alt: Thiết kế camera độc đáo	alt : Thiết kế camera độc đáo

des: Thiết kế camera độc đáo	des : Thiết kế camera độc đáo

Thiết kế camera độc đáo.	Thiết kế camera độc đáo .

CPU	CPU

CPU của 2 dòng điện thoại đều là  Exynos 850 8 nhân .	CPU của 2 dòng điện thoại đều là Exynos 850 8 nhân .

Con chip này sẽ mang lại sự ổn định giúp hai chiếc máy xử lý tốt được những tác vụ cơ bản hằng ngày.	Con chip này sẽ mang lại sự ổn định giúp hai chiếc máy xử lý tốt được những tác vụ cơ bản hằng ngày .

alt: Cấu hình điện thoại Samsung Galaxy A12	alt : Cấu hình điện thoại Samsung Galaxy A12

des: Cấu hình điện thoại Samsung Galaxy A12	des : Cấu hình điện thoại Samsung Galaxy A12

Cấu hình điện thoại Samsung Galaxy A12.	Cấu hình điện thoại Samsung Galaxy A12 .

Pin và sạc	Pin và sạc

Nếu bạn đang tìm một chiếc điện thoại có thể dùng cả ngày mà không cần phải sạc thì dung lượng của cả 2 dòng điện thoại này đều có thể làm bạn hài lòng với dung lượng pin  5000 mAh  và hỗ trợ sạc  15W .	Nếu bạn đang tìm một chiếc điện thoại có thể dùng cả ngày mà không cần phải sạc thì dung lượng của cả 2 dòng điện thoại này đều có thể làm bạn hài lòng với dung lượng pin 5000 mAh và hỗ trợ sạc 15W .
{"subject": ["23&&cả", "24&&2", "25&&dòng", "26&&điện", "27&&thoại", "28&&này"], "object": ["23&&cả", "24&&2", "25&&dòng", "26&&điện", "27&&thoại", "28&&này"], "aspect": ["20&&dung", "21&&lượng"], "predicate": ["29&&đều", "30&&có", "31&&thể", "32&&làm", "33&&bạn", "34&&hài", "35&&lòng"], "label": "EQL"}

Loại pin của Samsung Galaxy A12 là  Li-Ion  và của A13 là  Li-Po .	Loại pin của Samsung Galaxy A12 là Li-Ion và của A13 là Li-Po .

alt: Điện thoại hỗ trợ sạc nhanh 15W	alt : Điện thoại hỗ trợ sạc nhanh 15W

des: Điện thoại hỗ trợ sạc nhanh 15W	des : Điện thoại hỗ trợ sạc nhanh 15W

Điện thoại hỗ trợ sạc nhanh 15W.	Điện thoại hỗ trợ sạc nhanh 15W .

Tiện ích	Tiện ích

Cả 2 chiếc điện thoại đều có khả năng bảo mật cao với mở khóa bằng khuôn mặt và bằng vân tay cạnh viền.	Cả 2 chiếc điện thoại đều có khả năng bảo mật cao với mở khóa bằng khuôn mặt và bằng vân tay cạnh viền .
{"subject": ["1&&Cả", "2&&2", "3&&chiếc", "4&&điện", "5&&thoại"], "object": ["1&&Cả", "2&&2", "3&&chiếc", "4&&điện", "5&&thoại"], "aspect": ["8&&khả", "9&&năng", "10&&bảo", "11&&mật", "12&&cao"], "predicate": ["6&&đều", "7&&có"], "label": "EQL"}

Điện thoại Samsung Galaxy A13 có phần hiện đại hơn khi ngoài tính năng ghi âm mặc định giống Samsung Galaxy A12, nó còn có thể  ghi âm cuộc gọi .	Điện thoại Samsung Galaxy A13 có phần hiện đại hơn khi ngoài tính năng ghi âm mặc định giống Samsung Galaxy A12 , nó còn có thể ghi âm cuộc gọi .
{"subject": ["1&&Điện", "2&&thoại", "3&&Samsung", "4&&Galaxy", "5&&A13"], "object": [], "aspect": [], "predicate": ["6&&có", "7&&phần", "8&&hiện", "9&&đại", "10&&hơn"], "label": "COM+"}

alt: Cả 2 dòng điện thoại đều có cảm biến vân tay cạnh viền	alt : Cả 2 dòng điện thoại đều có cảm biến vân tay cạnh viền

des: Cả 2 dòng điện thoại đều có cảm biến vân tay cạnh viền	des : Cả 2 dòng điện thoại đều có cảm biến vân tay cạnh viền
{"subject": ["3&&Cả", "4&&2", "5&&dòng", "6&&điện", "7&&thoại"], "object": ["3&&Cả", "4&&2", "5&&dòng", "6&&điện", "7&&thoại"], "aspect": ["10&&cảm", "11&&biến", "12&&vân", "13&&tay", "14&&cạnh", "15&&viền"], "predicate": ["8&&đều", "9&&có"], "label": "EQL"}

Cả 2 dòng điện thoại đều có cảm biến vân tay cạnh viền.	Cả 2 dòng điện thoại đều có cảm biến vân tay cạnh viền .
{"subject": ["1&&Cả", "2&&2", "3&&dòng", "4&&điện", "5&&thoại"], "object": ["1&&Cả", "2&&2", "3&&dòng", "4&&điện", "5&&thoại"], "aspect": ["8&&cảm", "9&&biến", "10&&vân", "11&&tay", "12&&cạnh", "13&&viền"], "predicate": ["6&&đều", "7&&có"], "label": "EQL"}

4.	4 .

Bảng so sánh Samsung Galaxy A12 và Samsung Galaxy A13	Bảng so sánh Samsung Galaxy A12 và Samsung Galaxy A13

5.	5 .

Nên mua Samsung Galaxy A12 hay Samsung Galaxy A13	Nên mua Samsung Galaxy A12 hay Samsung Galaxy A13

Cả 2 dòng điện thoại đều có những ưu nhược điểm nhất định và không có nhiều sự khác biệt lớn.	Cả 2 dòng điện thoại đều có những ưu nhược điểm nhất định và không có nhiều sự khác biệt lớn .

Chúng  đều thuộc phân khúc điện thoại giá rẻ  và có  thiết kế và màu sắc hiện đại .	Chúng đều thuộc phân khúc điện thoại giá rẻ và có thiết kế và màu sắc hiện đại .

Tùy thuộc vào bạn thích kiểu thiết kế nào mà có thể chọn chiếc điện thoại phù hợp cho mình.	Tùy thuộc vào bạn thích kiểu thiết kế nào mà có thể chọn chiếc điện thoại phù hợp cho mình .

Thông qua những so sánh ở trên đã chỉ ra 2 chiếc điện thoại này  khá giống nhau về cấu hình  đáp ứng những trải nghiệm cơ bản như xem phim, chơi game,...	Thông qua những so sánh ở trên đã chỉ ra 2 chiếc điện thoại này khá giống nhau về cấu hình đáp ứng những trải nghiệm cơ bản như xem phim , chơi game , . . .

Điện thoại Samsung Galaxy A13 có giá thành cao hơn và ra đời sau một thời gian ngắn, chính vì vậy mà chiếc điện thoại này đã được nâng cấp với nhiều tính năng nổi bật hơn.	Điện thoại Samsung Galaxy A13 có giá thành cao hơn và ra đời sau một thời gian ngắn , chính vì vậy mà chiếc điện thoại này đã được nâng cấp với nhiều tính năng nổi bật hơn .
{"subject": ["1&&Điện", "2&&thoại", "3&&Samsung", "4&&Galaxy", "5&&A13"], "object": [], "aspect": ["7&&giá", "8&&thành"], "predicate": ["9&&cao", "10&&hơn"], "label": "COM-"}
{"subject": ["1&&Điện", "2&&thoại", "3&&Samsung", "4&&Galaxy", "5&&A13"], "object": [], "aspect": ["33&&nhiều", "34&&tính", "35&&năng"], "predicate": ["36&&nổi", "37&&bật", "38&&hơn"], "label": "COM+"}

alt: Nên mua điện thoại nào?	alt : Nên mua điện thoại nào ?

des: Nên mua điện thoại nào?	des : Nên mua điện thoại nào ?

Nên mua điện thoại nào?.	Nên mua điện thoại nào ? .

6.	6 .

Chính sách bảo hành khi mua Samsung Galaxy A12 và Samsung Galaxy A13 tại TGDĐ	Chính sách bảo hành khi mua Samsung Galaxy A12 và Samsung Galaxy A13 tại TGDĐ

Khi mua điện thoại Samsung Galaxy A12 và Samsung Galaxy A13 tại  Thế Giới Di Động , bạn sẽ nhận được chính sách bảo hành như sau:	Khi mua điện thoại Samsung Galaxy A12 và Samsung Galaxy A13 tại Thế Giới Di Động , bạn sẽ nhận được chính sách bảo hành như sau :

- Đảm bảo  hư gì đổi nấy trong vòng 12 tháng  tại các siêu thị trên toàn quốc.	- Đảm bảo hư gì đổi nấy trong vòng 12 tháng tại các siêu thị trên toàn quốc .

- Sản phẩm được  bảo hành 1 năm .	- Sản phẩm được bảo hành 1 năm .

alt: Chính sách bảo hành TGDĐ	alt : Chính sách bảo hành TGDĐ

des: Chính sách bảo hành TGDĐ	des : Chính sách bảo hành TGDĐ

Chính sách bảo hành TGDĐ.	Chính sách bảo hành TGDĐ .

Bài viết trên đây đã so sánh điện thoại Samsung Galaxy A12 và Samsung Galaxy A13.	Bài viết trên đây đã so sánh điện thoại Samsung Galaxy A12 và Samsung Galaxy A13 .

Với những thông tin về đặc điểm của 2 dòng điện thoại, hy vọng có thể giúp bạn lựa chọn một điện thoại phù hợp.	Với những thông tin về đặc điểm của 2 dòng điện thoại , hy vọng có thể giúp bạn lựa chọn một điện thoại phù hợp .

