title: “Đập hộp” Galaxy S20 Ultra: choáng ngợp với những tính năng khủng	title : “ Đập hộp ” Galaxy S20 Ultra : choáng ngợp với những tính năng khủng

Galaxy S20 Ultra đã chính thức được Samsung giới thiệu với nhiều tính năng lần đầu xuất hiện trên dòng Galaxy S. Hãy cùng Hoàng Hà Mobile mở hộp Galaxy S20 Ultra mới để khám phá những tính năng đỉnh cao của Samsung nha.	Galaxy S20 Ultra đã chính thức được Samsung giới thiệu với nhiều tính năng lần đầu xuất hiện trên dòng Galaxy S . Hãy cùng Hoàng Hà Mobile mở hộp Galaxy S20 Ultra mới để khám phá những tính năng đỉnh cao của Samsung nha .

Mở hộp Galaxy S20 Ultra	Mở hộp Galaxy S20 Ultra

Hộp của máy có thiết kế đơn giản, sang trọng với tông màu đen chủ đạo.	Hộp của máy có thiết kế đơn giản , sang trọng với tông màu đen chủ đạo .

Nổi bật trên nắp hộp là dòng chữ S20 Ultra màu trắng và logo S20 màu xám ngay chính giữa.	Nổi bật trên nắp hộp là dòng chữ S20 Ultra màu trắng và logo S20 màu xám ngay chính giữa .

Hộp đựng Galaxy S20 Ultra cũng có kích thước lớn nhất trong Galaxy S20 Series vừa ra mắt.	Hộp đựng Galaxy S20 Ultra cũng có kích thước lớn nhất trong Galaxy S20 Series vừa ra mắt .
{"subject": ["1&&Hộp", "2&&đựng", "3&&Galaxy", "4&&S20", "5&&Ultra"], "object": [], "aspect": ["8&&kích", "9&&thước"], "predicate": ["10&&lớn", "11&&nhất", "12&&trong", "13&&Galaxy", "14&&S20", "15&&Series", "16&&vừa", "17&&ra", "18&&mắt"], "label": "SUP"}

alt: anh 1	alt : anh 1

des:	des :

Bên trong hộp chúng ta sẽ có củ sạc 25W, cáp sạc C-to-C, tai nghe AKG kết nối qua cổng type-C và que chọc sim.	Bên trong hộp chúng ta sẽ có củ sạc 25W , cáp sạc C-to-C , tai nghe AKG kết nối qua cổng type-C và que chọc sim .

Samsung cũng hào phóng tặng cho người dùng một chiếc ốp lưng trong suốt để bảo vệ máy.	Samsung cũng hào phóng tặng cho người dùng một chiếc ốp lưng trong suốt để bảo vệ máy .

Galaxy S20 Ultra được khoác lên mình bộ viền rất chắc chắn bằng thép không gỉ.	Galaxy S20 Ultra được khoác lên mình bộ viền rất chắc chắn bằng thép không gỉ .

Đây cũng là lần đầu tiên Samsung đưa bộ viền này lên sản phẩm của mình.	Đây cũng là lần đầu tiên Samsung đưa bộ viền này lên sản phẩm của mình .

Nhờ đó, khả năng chống chịu va đập của máy được nâng cao hơn.	Nhờ đó , khả năng chống chịu va đập của máy được nâng cao hơn .
{"subject": ["11&&máy"], "object": [], "aspect": ["4&&khả", "5&&năng", "6&&chống", "7&&chịu", "8&&va", "9&&đập"], "predicate": ["13&&nâng", "14&&cao", "15&&hơn"], "label": "COM+"}

Đồng thời viền thép cũng giúp máy đầm tay hơn khi sử dụng.	Đồng thời viền thép cũng giúp máy đầm tay hơn khi sử dụng .
{"subject": ["7&&máy"], "object": [], "aspect": [], "predicate": ["8&&đầm", "9&&tay", "10&&hơn"], "label": "COM+"}

alt: anh 3	alt : anh 3

des:	des :

Bên cạnh trái máy sẽ hoàn toàn trống trơn, bên cạnh phải sẽ là nơi đặt toàn bộ phím bấm của máy gồm nút nguồn và âm lượng, cạnh trên là nơi để khay sim và cạnh dưới là cổng sạc USB type-C cùng micro và loa.	Bên cạnh trái máy sẽ hoàn toàn trống trơn , bên cạnh phải sẽ là nơi đặt toàn bộ phím bấm của máy gồm nút nguồn và âm lượng , cạnh trên là nơi để khay sim và cạnh dưới là cổng sạc USB type-C cùng micro và loa .

Một vẻ ngoài sáng bóng toát lên nhờ vào viền thép càng làm chiếc trở nên nổi bật khi đưa dưới ánh sáng.	Một vẻ ngoài sáng bóng toát lên nhờ vào viền thép càng làm chiếc trở nên nổi bật khi đưa dưới ánh sáng .

alt: anh 4	alt : anh 4

des:	des :

Mặt lưng của Galaxy S20 Ultra được bao phủ bởi kính cường lực cùng một cụm camera khá lớn tạo điểm nhấn.	Mặt lưng của Galaxy S20 Ultra được bao phủ bởi kính cường lực cùng một cụm camera khá lớn tạo điểm nhấn .

Bản mình cầm có mặt lưng màu xám nhìn khá nam tính.	Bản mình cầm có mặt lưng màu xám nhìn khá nam tính .

Thêm một chút nữa là cụm camera hơi to thì mình nghĩ rằng S20 Ultra sẽ phù hợp với những bạn nam hơn.	Thêm một chút nữa là cụm camera hơi to thì mình nghĩ rằng S20 Ultra sẽ phù hợp với những bạn nam hơn .

Nhưng nếu bạn nữ là người cá tính và mạnh mẽ thì sở hữu chiếc máy này cũng là một sự lựa không hề tồi đâu nhé.	Nhưng nếu bạn nữ là người cá tính và mạnh mẽ thì sở hữu chiếc máy này cũng là một sự lựa không hề tồi đâu nhé .

alt: anh 5	alt : anh 5

des:	des :

Galaxy S20 Ultra được trang bị màn hình 6,9 inch Infinity-O với công nghệ Dynamic AMOLED, độ phân giải tối đa 2K+.	Galaxy S20 Ultra được trang bị màn hình 6,9 inch Infinity-O với công nghệ Dynamic AMOLED , độ phân giải tối đa 2K + .

Samsung vẫn luôn mạnh về công nghệ màn hình trong nhiều năm nay, và giờ họ vẫn làm rất tốt điểm này trên S20 Ultra.	Samsung vẫn luôn mạnh về công nghệ màn hình trong nhiều năm nay , và giờ họ vẫn làm rất tốt điểm này trên S20 Ultra .

Do đó, không quá ngạc nhiên khi nhiều trang đánh giá uy tín của nước ngoài đều chọn đây là chiếc máy có màn hình đẹp nhất hiện nay.	Do đó , không quá ngạc nhiên khi nhiều trang đánh giá uy tín của nước ngoài đều chọn đây là chiếc máy có màn hình đẹp nhất hiện nay .
{"subject": ["22&&chiếc", "23&&máy"], "object": [], "aspect": ["25&&màn", "26&&hình"], "predicate": ["27&&đẹp", "28&&nhất", "29&&hiện", "30&&nay"], "label": "SUP+"}

alt: anh 6	alt : anh 6

des:	des :

Độ bo cong hai cạnh bên trên S20 Ultra đã được giảm bớt khi so với S10.	Độ bo cong hai cạnh bên trên S20 Ultra đã được giảm bớt khi so với S10 .
{"subject": ["8&&S20", "9&&Ultra"], "object": ["17&&S10"], "aspect": ["1&&Độ", "2&&bo", "3&&cong", "4&&hai", "5&&cạnh", "6&&bên"], "predicate": ["12&&giảm", "13&&bớt"], "label": "COM"}

Chính vì vậy thao tác trên máy đỡ bị cảm ứng nhầm hơn rất nhiều.	Chính vì vậy thao tác trên máy đỡ bị cảm ứng nhầm hơn rất nhiều .
{"subject": ["7&&máy"], "object": [], "aspect": ["4&&thao", "5&&tác"], "predicate": ["8&&đỡ", "9&&bị", "10&&cảm", "11&&ứng", "12&&nhầm", "13&&hơn", "14&&rất", "15&&nhiều"], "label": "COM+"}

Các viền trên viền dưới cũng được làm khá mỏng.	Các viền trên viền dưới cũng được làm khá mỏng .

Chính những điều này đã giúp máy có màn hình lớn nhưng vẫn rất gọn gàng trong bàn tay của người sử dụng.	Chính những điều này đã giúp máy có màn hình lớn nhưng vẫn rất gọn gàng trong bàn tay của người sử dụng .

alt: anh 7	alt : anh 7

des:	des :

Công nghệ màn hình 120Hz có thể nói là điểm nhấn lớn nhất trên màn hình.	Công nghệ màn hình 120Hz có thể nói là điểm nhấn lớn nhất trên màn hình .

Các trải nghiệm thao tác với chế độ này vô cùng mượt mà.	Các trải nghiệm thao tác với chế độ này vô cùng mượt mà .

Nếu bạn đang quen với màn hình 60Hz thì chắc chắn 120Hz trên S20 Ultra sẽ không làm bạn thất vọng.	Nếu bạn đang quen với màn hình 60Hz thì chắc chắn 120Hz trên S20 Ultra sẽ không làm bạn thất vọng .

Nhưng khi bật chế độ này độ phân giải màn hình của máy sẽ giảm xuống chỉ còn Full HD+.	Nhưng khi bật chế độ này độ phân giải màn hình của máy sẽ giảm xuống chỉ còn Full HD + .

Tuy nhiên, dù sử dụng ở độ phân giải Full HD+ thì trải nghiệm hình ảnh vẫn rất mịn và ít gặp tình trạng bị rỗ màn hình.	Tuy nhiên , dù sử dụng ở độ phân giải Full HD + thì trải nghiệm hình ảnh vẫn rất mịn và ít gặp tình trạng bị rỗ màn hình .

alt: anh 8	alt : anh 8

des:	des :

Cấu hình được trang bị trên S20 Ultra là con chip Exynos 990 mạnh mẽ nhất của Samsung, Ram 12GB thoải mái cho việc đa nhiệm cùng bộ nhớ trong 128GB.	Cấu hình được trang bị trên S20 Ultra là con chip Exynos 990 mạnh mẽ nhất của Samsung , Ram 12GB thoải mái cho việc đa nhiệm cùng bộ nhớ trong 128GB .
{"subject": ["7&&S20", "8&&Ultra"], "object": [], "aspect": ["10&&con", "11&&chip", "12&&Exynos", "13&&990"], "predicate": ["14&&mạnh", "15&&mẽ", "16&&nhất", "17&&của", "18&&Samsung"], "label": "SUP+"}

Nếu dung lượng này chưa đủ, bạn có thể mở rộng thông qua thẻ nhớ (tối đa 1TB).	Nếu dung lượng này chưa đủ , bạn có thể mở rộng thông qua thẻ nhớ ( tối đa 1TB ) .

Trải nghiệm nhanh việc chơi game, máy hoàn toàn đáp ứng tốt tựa game Liên Quân Mobile, PUBG Mobile và Asphalt Extreme.	Trải nghiệm nhanh việc chơi game , máy hoàn toàn đáp ứng tốt tựa game Liên Quân Mobile , PUBG Mobile và Asphalt Extreme .

alt: anh 9	alt : anh 9

des:	des :

Cụm camera có kích thước lớn chính vì chứa đựng nhiều công nghệ bên trong.	Cụm camera có kích thước lớn chính vì chứa đựng nhiều công nghệ bên trong .

Điểm qua chút về thông số chúng ta sẽ có camera góc rộng 108MP, khẩu độ f/1.8, camera góc siêu rộng 12MP, camera cảm biến đo chiều sâu và đặc biệt là camera tele 48MP.	Điểm qua chút về thông số chúng ta sẽ có camera góc rộng 108MP , khẩu độ f / 1.8 , camera góc siêu rộng 12MP , camera cảm biến đo chiều sâu và đặc biệt là camera tele 48MP .

Camera 108MP còn có thể gộp 9 điểm ảnh làm 1.	Camera 108MP còn có thể gộp 9 điểm ảnh làm 1 .

Điều này giúp tăng chi tiết cũng như nâng chất lượng những bức ảnh chụp thiếu sáng.	Điều này giúp tăng chi tiết cũng như nâng chất lượng những bức ảnh chụp thiếu sáng .

Rất nhiều tính năng thú vị khác đã được Samsung thêm vào để làm hài lòng người dùng.	Rất nhiều tính năng thú vị khác đã được Samsung thêm vào để làm hài lòng người dùng .

alt: anh 10	alt : anh 10

des:	des :

Khả năng zoom điện tử lên tới 100x cũng là điều làm giới yêu công nghệ vô cùng háo hức.	Khả năng zoom điện tử lên tới 100x cũng là điều làm giới yêu công nghệ vô cùng háo hức .

Bạn có thể sáng tạo được rất nhiều điều thú vị cùng camera này như là chụp những vật thể ở xa không thể lại gần hoặc chỉ đơn giản là thay thế cho một chiếc ống nhòm to và cồng kềnh.	Bạn có thể sáng tạo được rất nhiều điều thú vị cùng camera này như là chụp những vật thể ở xa không thể lại gần hoặc chỉ đơn giản là thay thế cho một chiếc ống nhòm to và cồng kềnh .

alt: anh 11	alt : anh 11

des:	des :

Đối với quay video trên S20 Ultra sẽ có tính năng quay phim Siêu ổn định rất được các vlogger ưa thích vì khả năng chống rung bá đạo mà lại không cần gimbal này.	Đối với quay video trên S20 Ultra sẽ có tính năng quay phim Siêu ổn định rất được các vlogger ưa thích vì khả năng chống rung bá đạo mà lại không cần gimbal này .

Thêm nữa máy còn hỗ trợ quay video có độ phân giải lên tới 8K, thậm chí lớn hơn cả chiếc máy ảnh mà mình đang sử dụng.	Thêm nữa máy còn hỗ trợ quay video có độ phân giải lên tới 8K , thậm chí lớn hơn cả chiếc máy ảnh mà mình đang sử dụng .
{"subject": ["3&&máy"], "object": ["22&&chiếc", "23&&máy", "24&&ảnh"], "aspect": ["5&&hỗ", "6&&trợ", "7&&quay", "8&&video", "9&&có", "10&&độ", "11&&phân", "12&&giải"], "predicate": ["19&&lớn", "20&&hơn"], "label": "COM+"}

alt: anh 12	alt : anh 12

des:	des :

Cuối cùng là về dung lượng pin, máy có pin 5.000mAh.	Cuối cùng là về dung lượng pin , máy có pin 5.000mAh .

Đây là một con số lớn và rất thoải mái cho một ngày sử dụng.	Đây là một con số lớn và rất thoải mái cho một ngày sử dụng .

Máy còn hỗ trợ sạc nhanh tới 45W nên việc sạc 5.000mAh cũng không tốn quá nhiều thời gian.	Máy còn hỗ trợ sạc nhanh tới 45W nên việc sạc 5.000mAh cũng không tốn quá nhiều thời gian .

Giả sử một ngày bạn trót chơi game hay chụp ảnh quá nhiều, cắm sạc một chút là lại đủ dùng ngay.	Giả sử một ngày bạn trót chơi game hay chụp ảnh quá nhiều , cắm sạc một chút là lại đủ dùng ngay .

alt: anh 13	alt : anh 13

des:	des :

Tạm kết	Tạm kết

Tổng kết lại, Galaxy S20 Ultra là một chiếc máy cực kỳ đáng mua.	Tổng kết lại , Galaxy S20 Ultra là một chiếc máy cực kỳ đáng mua .

Những ai thích trải nghiệm công nghệ mới sẽ không thất vọng khi cầm trên tay chiếc máy này.	Những ai thích trải nghiệm công nghệ mới sẽ không thất vọng khi cầm trên tay chiếc máy này .

Hiện tại Galaxy S20 Ultra đã chính thức được đưa lên kệ Hoàng Hà Mobile.	Hiện tại Galaxy S20 Ultra đã chính thức được đưa lên kệ Hoàng Hà Mobile .

Khi mua Galaxy S20 Series tại Hoàng Hà, khách hàng sẽ được tặng bộ quà trị giá tới 10.000.000đ.	Khi mua Galaxy S20 Series tại Hoàng Hà , khách hàng sẽ được tặng bộ quà trị giá tới 10.000.000đ .

Không chỉ vậy, trong hai ngày 7 và 8/3, Hoàng Hà sẽ giảm thẳng 2.000.000đ vào giá máy, giảm thêm 500.000đ với khách hàng thân thiết.	Không chỉ vậy , trong hai ngày 7 và 8 / 3 , Hoàng Hà sẽ giảm thẳng 2.000.000đ vào giá máy , giảm thêm 500.000đ với khách hàng thân thiết .

Hãy đặt mua ngay để không bỏ lỡ những ưu đãi hấp dẫn này nha.	Hãy đặt mua ngay để không bỏ lỡ những ưu đãi hấp dẫn này nha .

Tham gia Hoàng Hà Mobile Group để cập nhật những chương trình và ưu đãi sớm nhất	Tham gia Hoàng Hà Mobile Group để cập nhật những chương trình và ưu đãi sớm nhất

Cùng Follow kênh Youtube của Hoàng Hà Mobile để cập nhật những tin tức mới nhất, sinh động nhất nhé!	Cùng Follow kênh Youtube của Hoàng Hà Mobile để cập nhật những tin tức mới nhất , sinh động nhất nhé !

