title: So sánh Oppo Find N2 Flip và Samsung Galaxy Z Flip 4: Nên mua máy nào?	title : So sánh Oppo Find N2 Flip và Samsung Galaxy Z Flip 4 : Nên mua máy nào ?

Bên cạnh việc là  smartphone  nắp gập đầu tiên của thương hiệu, đây cũng sẽ là điện thoại màn hình gập đầu tiên của Oppo tung ra thị trường toàn cầu.	Bên cạnh việc là smartphone nắp gập đầu tiên của thương hiệu , đây cũng sẽ là điện thoại màn hình gập đầu tiên của Oppo tung ra thị trường toàn cầu .

Khi đó, thiết bị này sẽ gặp phải một đối thủ quan trọng và duy nhất là  Galaxy Z Flip 4 .	Khi đó , thiết bị này sẽ gặp phải một đối thủ quan trọng và duy nhất là Galaxy Z Flip 4 .

Hãy cùng so sánh  Oppo Find N2 Flip  và Samsung Galaxy Z Flip 4: Nên mua máy nào?	Hãy cùng so sánh Oppo Find N2 Flip và Samsung Galaxy Z Flip 4 : Nên mua máy nào ?

1.	1 .

Tổng quan về điện thoại Oppo Find N2 Flip	Tổng quan về điện thoại Oppo Find N2 Flip

Thiết kế màn hình gập của Find N2 Flip với tỷ lệ khung hình rộng và viền mỏng.	Thiết kế màn hình gập của Find N2 Flip với tỷ lệ khung hình rộng và viền mỏng .

Điểm thú vị nhất trên  điện thoại Oppo  mới này là màn hình phụ.	Điểm thú vị nhất trên điện thoại Oppo mới này là màn hình phụ .

Nhờ kích thước lớn, màn hình này có thể tận dụng để hiển thị một bảng dự báo thời tiết lớn, danh sách thông báo hay trình phát nhạc.	Nhờ kích thước lớn , màn hình này có thể tận dụng để hiển thị một bảng dự báo thời tiết lớn , danh sách thông báo hay trình phát nhạc .

Phần mặt lưng được hoàn thiện từ chất liệu kim loại nhám cao cấp mang đến vẻ ngoài bền bỉ và hạn chế được tình trạng bám mồ hôi hoặc vân tay khi sử dụng.	Phần mặt lưng được hoàn thiện từ chất liệu kim loại nhám cao cấp mang đến vẻ ngoài bền bỉ và hạn chế được tình trạng bám mồ hôi hoặc vân tay khi sử dụng .

Oppo Find N2 Flip có màn hình gập được, khi mở ra thì chúng ta có một chiếc smartphone như bình thường.	Oppo Find N2 Flip có màn hình gập được , khi mở ra thì chúng ta có một chiếc smartphone như bình thường .

alt: Tỷ lệ khung hình rộng và viền mỏng	alt : Tỷ lệ khung hình rộng và viền mỏng

des: Tỷ lệ khung hình rộng và viền mỏng	des : Tỷ lệ khung hình rộng và viền mỏng

2.	2 .

Tổng quan về điện thoại Samsung Galaxy Z Flip 4	Tổng quan về điện thoại Samsung Galaxy Z Flip 4

Galaxy Z Flip 4 được thiết kế vuông vắn hơn nhờ tạo hình vát phẳng ở hai mặt và các cạnh, phần mặt lưng của  điện thoại Samsung  này được phủ một lớp nhám nhẹ giúp cầm nắm chắc tay hơn, hạn chế được tình trạng bám dấu vân tay trong quá trình sử dụng.	Galaxy Z Flip 4 được thiết kế vuông vắn hơn nhờ tạo hình vát phẳng ở hai mặt và các cạnh , phần mặt lưng của điện thoại Samsung này được phủ một lớp nhám nhẹ giúp cầm nắm chắc tay hơn , hạn chế được tình trạng bám dấu vân tay trong quá trình sử dụng .

Bộ khung và bản lề của sản phẩm được hoàn thiện từ vật liệu Armor Aluminum cứng cáp.	Bộ khung và bản lề của sản phẩm được hoàn thiện từ vật liệu Armor Aluminum cứng cáp .

Liên kết giữa các chi tiết được làm khít lại để giúp máy có thể kháng nước tốt hơn với chuẩn  IPX8 , giao diện chụp ảnh chia đôi màn hình đã hỗ trợ trên ứng dụng camera bên thứ 3.	Liên kết giữa các chi tiết được làm khít lại để giúp máy có thể kháng nước tốt hơn với chuẩn IPX8 , giao diện chụp ảnh chia đôi màn hình đã hỗ trợ trên ứng dụng camera bên thứ 3 .

alt: Thiết kế vuông vắn hơn nhờ tạo hình vát phẳng ở hai mặt và các cạnh	alt : Thiết kế vuông vắn hơn nhờ tạo hình vát phẳng ở hai mặt và các cạnh

des: Thiết kế vuông vắn hơn nhờ tạo hình vát phẳng ở hai mặt và các cạnh	des : Thiết kế vuông vắn hơn nhờ tạo hình vát phẳng ở hai mặt và các cạnh

3.	3 .

So sánh điện thoại Oppo Find N2 Flip với Samsung Z Flip 4	So sánh điện thoại Oppo Find N2 Flip với Samsung Z Flip 4

Thiết kế	Thiết kế

Galaxy Z Flip 4 và Find N2 Flip có ngôn ngữ thiết kế khá giống nhau.	Galaxy Z Flip 4 và Find N2 Flip có ngôn ngữ thiết kế khá giống nhau .
{"subject": ["1&&Galaxy", "2&&Z", "3&&Flip", "4&&4"], "object": ["6&&Find", "7&&N2", "8&&Flip"], "aspect": ["10&&ngôn", "11&&ngữ", "12&&thiết", "13&&kế"], "predicate": ["14&&khá", "15&&giống", "16&&nhau"], "label": "EQL"}

Cả hai điện thoại này đều sở hữu màn hình gập dọc dạng vỏ sò với bản lề nằm chính giữa.	Cả hai điện thoại này đều sở hữu màn hình gập dọc dạng vỏ sò với bản lề nằm chính giữa .
{"subject": ["1&&Cả", "2&&hai", "3&&điện", "4&&thoại"], "object": ["1&&Cả", "2&&hai", "3&&điện", "4&&thoại"], "aspect": ["9&&màn", "10&&hình", "11&&gập", "12&&dọc", "13&&dạng", "14&&vỏ", "15&&sò", "16&&với", "17&&bản", "18&&lề", "19&&nằm", "20&&chính", "21&&giữa"], "predicate": ["6&&đều", "7&&sở", "8&&hữu"], "label": "EQL"}

Bộ đôi này còn được hoàn thiện từ chất liệu cao cấp, bao gồm mặt lưng kính và khung nhôm.	Bộ đôi này còn được hoàn thiện từ chất liệu cao cấp , bao gồm mặt lưng kính và khung nhôm .

Khi mở ra, cả Galaxy Z Flip 4 và Find N2 Flip trông giống như những chiếc điện thoại bình thường với màn hình phụ ở phía sau, nhưng khi gập lại thì bạn sẽ có những thiết bị cực kỳ nhỏ gọn, dễ dàng cầm nắm bằng một tay.	Khi mở ra , cả Galaxy Z Flip 4 và Find N2 Flip trông giống như những chiếc điện thoại bình thường với màn hình phụ ở phía sau , nhưng khi gập lại thì bạn sẽ có những thiết bị cực kỳ nhỏ gọn , dễ dàng cầm nắm bằng một tay .
{"subject": ["6&&Galaxy", "7&&Z", "8&&Flip", "9&&4"], "object": ["17&&những", "18&&chiếc", "19&&điện", "20&&thoại", "21&&bình", "22&&thường"], "aspect": [], "predicate": ["14&&trông", "15&&giống", "16&&như"], "label": "EQL"}
{"subject": ["11&&Find", "12&&N2", "13&&Flip"], "object": ["17&&những", "18&&chiếc", "19&&điện", "20&&thoại", "21&&bình", "22&&thường"], "aspect": [], "predicate": ["14&&trông", "15&&giống", "16&&như"], "label": "EQL"}

Hơn nữa, Galaxy Z Flip 4 còn hỗ trợ khả năng kháng nước đạt tiêu chuẩn IPX8, tính năng mà Find N2 Flip đã bỏ lỡ.	Hơn nữa , Galaxy Z Flip 4 còn hỗ trợ khả năng kháng nước đạt tiêu chuẩn IPX8 , tính năng mà Find N2 Flip đã bỏ lỡ .

alt: Ngôn ngữ thiết kế khá giống nhau	alt : Ngôn ngữ thiết kế khá giống nhau

des: Ngôn ngữ thiết kế khá giống nhau	des : Ngôn ngữ thiết kế khá giống nhau

Màn hình	Màn hình

Các thông số màn hình chính của Oppo Find N2 Flip và Z Flip 4 không có nhiều sự khác biệt.	Các thông số màn hình chính của Oppo Find N2 Flip và Z Flip 4 không có nhiều sự khác biệt .
{"subject": ["8&&Oppo", "9&&Find", "10&&N2", "11&&Flip"], "object": ["13&&Z", "14&&Flip", "15&&4"], "aspect": ["2&&thông", "3&&số", "4&&màn", "5&&hình", "6&&chính"], "predicate": ["16&&không", "17&&có", "18&&nhiều", "19&&sự", "20&&khác", "21&&biệt"], "label": "EQL"}

alt: Find N2 Flip có kích thước nhỉnh hơn	alt : Find N2 Flip có kích thước nhỉnh hơn

des: Find N2 Flip có kích thước nhỉnh hơn	des : Find N2 Flip có kích thước nhỉnh hơn
{"subject": ["3&&Find", "4&&N2", "5&&Flip"], "object": [], "aspect": ["7&&kích", "8&&thước"], "predicate": ["9&&nhỉnh", "10&&hơn"], "label": "COM+"}

Độ phân giải 1080 x 2520 pixels cùng tần số quét 120Hz và độ sáng tối đa đạt 1600 nits.	Độ phân giải 1080 x 2520 pixels cùng tần số quét 120Hz và độ sáng tối đa đạt 1600 nits .

Samsung Z Flip 4 nhỏ hơn một chút với màn hình 6.7 inches, sử dụng tấm nền Dynamic AMOLED 2X.	Samsung Z Flip 4 nhỏ hơn một chút với màn hình 6.7 inches , sử dụng tấm nền Dynamic AMOLED 2X .
{"subject": ["1&&Samsung", "2&&Z", "3&&Flip", "4&&4"], "object": [], "aspect": ["10&&màn", "11&&hình"], "predicate": ["5&&nhỏ", "6&&hơn", "7&&một", "8&&chút"], "label": "COM-"}

Tần số quét 120Hz nhưng độ phân giải lên tới 1080x 2640 pixels.	Tần số quét 120Hz nhưng độ phân giải lên tới 1080x 2640 pixels .

Ngoài ra, màn hình phụ của Z Flip 4 có độ phân giải 260 x 512 Pixels nhỏ hơn so với màn hình phụ của Find N2 là 720 x 382 Pixels.	Ngoài ra , màn hình phụ của Z Flip 4 có độ phân giải 260 x 512 Pixels nhỏ hơn so với màn hình phụ của Find N2 là 720 x 382 Pixels .
{"subject": ["4&&màn", "5&&hình", "6&&phụ", "7&&của", "8&&Z", "9&&Flip", "10&&4"], "object": ["23&&màn", "24&&hình", "25&&phụ", "26&&của", "27&&Find", "28&&N2"], "aspect": ["12&&độ", "13&&phân", "14&&giải"], "predicate": ["19&&nhỏ", "20&&hơn"], "label": "COM-"}

alt: Find N2 Flip có kích thước nhỉnh hơn	alt : Find N2 Flip có kích thước nhỉnh hơn

des: Find N2 Flip có kích thước nhỉnh hơn	des : Find N2 Flip có kích thước nhỉnh hơn
{"subject": ["3&&Find", "4&&N2", "5&&Flip"], "object": [], "aspect": ["7&&kích", "8&&thước"], "predicate": ["9&&nhỉnh", "10&&hơn"], "label": "COM+"}

Camera	Camera

Oppo Find N2 Flip sở hữu phần máy ảnh ấn tượng hơn, gồm cảm biến chính Sony IMX890 tốt hơn với độ phân giải 50MP nhưng thiếu công nghệ  chống rung quang học (OIS) , trong khi camera chính Galaxy Z Flip 4 có tính năng này nhưng chỉ sở hữu độ phân giải 12MP.	Oppo Find N2 Flip sở hữu phần máy ảnh ấn tượng hơn , gồm cảm biến chính Sony IMX890 tốt hơn với độ phân giải 50MP nhưng thiếu công nghệ chống rung quang học ( OIS ) , trong khi camera chính Galaxy Z Flip 4 có tính năng này nhưng chỉ sở hữu độ phân giải 12MP .
{"subject": ["1&&Oppo", "2&&Find", "3&&N2", "4&&Flip"], "object": ["43&&Galaxy", "44&&Z", "45&&Flip", "46&&4"], "aspect": ["8&&máy", "9&&ảnh"], "predicate": ["10&&ấn", "11&&tượng", "12&&hơn"], "label": "COM+"}
{"subject": ["1&&Oppo", "2&&Find", "3&&N2", "4&&Flip"], "object": ["43&&Galaxy", "44&&Z", "45&&Flip", "46&&4"], "aspect": ["15&&cảm", "16&&biến", "17&&chính"], "predicate": ["20&&tốt", "21&&hơn"], "label": "COM+"}

Camera selfie của điện thoại Oppo có độ phân giải lên tới 32MP với HDR và panorama.	Camera selfie của điện thoại Oppo có độ phân giải lên tới 32MP với HDR và panorama .

Về cơ bản, chất lượng camera của hai máy đều mang đến những bức ảnh hấp dẫn người chụp.	Về cơ bản , chất lượng camera của hai máy đều mang đến những bức ảnh hấp dẫn người chụp .
{"subject": ["9&&hai", "10&&máy"], "object": ["9&&hai", "10&&máy"], "aspect": ["5&&chất", "6&&lượng", "7&&camera"], "predicate": ["11&&đều", "12&&mang", "13&&đến", "14&&những", "15&&bức", "16&&ảnh", "17&&hấp", "18&&dẫn", "19&&người", "20&&chụp"], "label": "EQL"}

Tuy nhiên với thông số cao hơn đi kèm các thuật toán hỗ trợ chụp ảnh, camera của Find N2 Flip hấp dẫn hơn chiếc điện thoại gập còn lại.	Tuy nhiên với thông số cao hơn đi kèm các thuật toán hỗ trợ chụp ảnh , camera của Find N2 Flip hấp dẫn hơn chiếc điện thoại gập còn lại .
{"subject": ["20&&Find", "21&&N2", "22&&Flip"], "object": ["26&&chiếc", "27&&điện", "28&&thoại", "29&&gập", "30&&còn", "31&&lại"], "aspect": ["18&&camera"], "predicate": ["23&&hấp", "24&&dẫn", "25&&hơn"], "label": "COM+"}
{"subject": ["20&&Find", "21&&N2", "22&&Flip"], "object": ["26&&chiếc", "27&&điện", "28&&thoại", "29&&gập", "30&&còn", "31&&lại"], "aspect": ["18&&camera"], "predicate": ["4&&thông", "5&&số", "6&&cao", "7&&hơn"], "label": "COM+"}

alt: OPPO Find N2 Flip sở hữu phần máy ảnh ấn tượng hơn	alt : OPPO Find N2 Flip sở hữu phần máy ảnh ấn tượng hơn

des: OPPO Find N2 Flip sở hữu phần máy ảnh ấn tượng hơn	des : OPPO Find N2 Flip sở hữu phần máy ảnh ấn tượng hơn
{"subject": ["3&&OPPO", "4&&Find", "5&&N2", "6&&Flip"], "object": [], "aspect": ["10&&máy", "11&&ảnh"], "predicate": ["12&&ấn", "13&&tượng", "14&&hơn"], "label": "COM+"}

Hiệu năng	Hiệu năng

Hai chiếc điện thoại gập được trang bị hai chip xử lý mạnh mẽ đến từ hai thương hiệu lớn.	Hai chiếc điện thoại gập được trang bị hai chip xử lý mạnh mẽ đến từ hai thương hiệu lớn .

Galaxy Z Flip 4 sử dụng chip  Snapdragon 8+ Gen 1  của nhà Qualcomm, N2 Flip sẽ dùng chip Dimensity 9000+ của Mediatek.	Galaxy Z Flip 4 sử dụng chip Snapdragon 8 + Gen 1 của nhà Qualcomm , N2 Flip sẽ dùng chip Dimensity 9000 + của Mediatek .

Đây đều là hai chip xử lý được đánh giá cao trong phân khúc cao cấp hiện nay.	Đây đều là hai chip xử lý được đánh giá cao trong phân khúc cao cấp hiện nay .

Trên lý thuyết, chip Dimensity 9000+ có hiệu suất hoạt động tốt hơn Snapdragon 8+ Gen 1.	Trên lý thuyết , chip Dimensity 9000 + có hiệu suất hoạt động tốt hơn Snapdragon 8 + Gen 1 .
{"subject": ["6&&Dimensity", "7&&9000", "8&&+"], "object": ["16&&Snapdragon", "17&&8", "18&&+", "19&&Gen", "20&&1"], "aspect": ["10&&hiệu", "11&&suất", "12&&hoạt", "13&&động"], "predicate": ["14&&tốt", "15&&hơn"], "label": "COM+"}

Tuy nhiên hai chip xử lý cùng được sản xuất trên tiến trình 4nm nhưng khả năng tiết kiệm điện năng lại không có quá nhiều chênh lệch.	Tuy nhiên hai chip xử lý cùng được sản xuất trên tiến trình 4nm nhưng khả năng tiết kiệm điện năng lại không có quá nhiều chênh lệch .
{"subject": ["3&&hai", "4&&chip", "5&&xử", "6&&lý"], "object": ["3&&hai", "4&&chip", "5&&xử", "6&&lý"], "aspect": ["16&&khả", "17&&năng", "18&&tiết", "19&&kiệm", "20&&điện", "21&&năng"], "predicate": ["23&&không", "24&&có", "25&&quá", "26&&nhiều", "27&&chênh", "28&&lệch"], "label": "EQL"}

alt: Trang bị hai chip xử lý mạnh mẽ đến từ hai thương hiệu lớn	alt : Trang bị hai chip xử lý mạnh mẽ đến từ hai thương hiệu lớn

des: Trang bị hai chip xử lý mạnh mẽ đến từ hai thương hiệu lớn	des : Trang bị hai chip xử lý mạnh mẽ đến từ hai thương hiệu lớn

Pin và sạc	Pin và sạc

Oppo đã trang bị viên pin có mức dung lượng 4300mAh cho điện thoại gập của hãng.	Oppo đã trang bị viên pin có mức dung lượng 4300mAh cho điện thoại gập của hãng .

Còn Z Flip 4 lại chỉ sở hữu viên pin dung lượng 3700mAh.	Còn Z Flip 4 lại chỉ sở hữu viên pin dung lượng 3700mAh .

Oppo còn hỗ trợ công nghệ sạc nhanh có dây 44W, so với sạc 25W của Z Flip 4.	Oppo còn hỗ trợ công nghệ sạc nhanh có dây 44W , so với sạc 25W của Z Flip 4 .

Do sức mạnh đến từ bộ vi xử lý tương tự nhau nên không có nhiều sự khác biệt về khả năng tiết kiệm điện năng.	Do sức mạnh đến từ bộ vi xử lý tương tự nhau nên không có nhiều sự khác biệt về khả năng tiết kiệm điện năng .
{"subject": [], "object": [], "aspect": ["6&&bộ", "7&&vi", "8&&xử", "9&&lý"], "predicate": ["10&&tương", "11&&tự", "12&&nhau"], "label": "EQL"}
{"subject": [], "object": [], "aspect": ["21&&khả", "22&&năng", "23&&tiết", "24&&kiệm", "25&&điện", "26&&năng"], "predicate": ["14&&không", "15&&có", "16&&nhiều", "17&&sự", "18&&khác", "19&&biệt"], "label": "DIF"}

Vậy nên với dung lượng cao hơn, Find N2 Flip có thời lượng hoạt động dài hơn thiết bị còn lại.	Vậy nên với dung lượng cao hơn , Find N2 Flip có thời lượng hoạt động dài hơn thiết bị còn lại .
{"subject": ["9&&Find", "10&&N2", "11&&Flip"], "object": ["19&&thiết", "20&&bị", "21&&còn", "22&&lại"], "aspect": ["13&&thời", "14&&lượng", "15&&hoạt", "16&&động"], "predicate": ["17&&dài", "18&&hơn"], "label": "COM+"}
{"subject": ["9&&Find", "10&&N2", "11&&Flip"], "object": ["19&&thiết", "20&&bị", "21&&còn", "22&&lại"], "aspect": ["4&&dung", "5&&lượng"], "predicate": ["6&&cao", "7&&hơn"], "label": "COM+"}

alt: Không có nhiều sự khác biệt về khả năng tiết kiệm điện năng	alt : Không có nhiều sự khác biệt về khả năng tiết kiệm điện năng

des: Không có nhiều sự khác biệt về khả năng tiết kiệm điện năng	des : Không có nhiều sự khác biệt về khả năng tiết kiệm điện năng
{"subject": [], "object": [], "aspect": ["10&&khả", "11&&năng", "12&&tiết", "13&&kiệm", "14&&điện", "15&&năng"], "predicate": ["3&&Không", "4&&có", "5&&nhiều", "6&&sự", "7&&khác", "8&&biệt"], "label": "EQL"}

4.	4 .

alt: Bạn có thể mua điện thoại tại Thế Giới Di Động	alt : Bạn có thể mua điện thoại tại Thế Giới Di Động

des: Bạn có thể mua điện thoại tại Thế Giới Di Động	des : Bạn có thể mua điện thoại tại Thế Giới Di Động

Bài viết trên đây đã giúp bạn so sánh Oppo Find N2 Flip và Samsung Galaxy Z Flip 4: Nên mua máy nào?	Bài viết trên đây đã giúp bạn so sánh Oppo Find N2 Flip và Samsung Galaxy Z Flip 4 : Nên mua máy nào ?

Hẹn gặp lại bạn ở các bài viết sau!	Hẹn gặp lại bạn ở các bài viết sau !

